PLAYED_ID,PLAYER_NAME,SEASON_NUM,POSITION,GAMES_PLAYED,GAMES_STARTED,MINUTES_PLAYED,FG,FG_ATTEMPTS,FG%,3PT,3PT_ATTEMPTS,3PT%,2PT,2PT_ATTEMPTS,2PT%,EFFECTIVE_FG%,FTS,FT_ATTEMPTS,FT%,OFFENSIVE_RBS,DEFENSIVE_RBS,TOTAL_RBS,ASSISTS,STEALS,BLOCKS,TURNOVERS,PFS,POINTS
1,Kenyon Martin,1,PF,68,68,2272,346,777,0.445,1,11,0.091,345,766,0.45,0.446,121,192,0.63,137,365,502,131,78,113,138,281,814
1,Kenyon Martin,2,PF,73,73,2504,445,962,0.463,15,67,0.224,430,895,0.48,0.47,181,267,0.678,113,275,388,192,90,121,172,261,1086
1,Kenyon Martin,3,PF,77,77,2628,509,1082,0.47,9,43,0.209,500,1039,0.481,0.475,256,392,0.653,164,476,640,185,98,70,192,294,1283
1,Kenyon Martin,4,PF,65,62,2252,439,900,0.488,7,25,0.28,432,875,0.494,0.492,201,294,0.684,133,484,617,160,95,82,168,230,1086
2,Stromile Swift,1,PF,80,6,1312,153,339,0.451,0,4,0,153,335,0.457,0.451,85,141,0.603,109,175,284,28,62,82,64,160,391
2,Stromile Swift,2,PF,68,14,1805,293,611,0.48,0,3,0,293,608,0.482,0.48,217,305,0.711,161,269,430,50,53,113,122,178,803
2,Stromile Swift,3,PF,67,26,1478,235,489,0.481,0,2,0,235,487,0.483,0.481,177,245,0.722,114,270,384,45,55,104,99,152,647
2,Stromile Swift,4,PF,77,10,1528,268,571,0.469,1,4,0.25,267,567,0.471,0.47,190,262,0.725,141,237,378,38,56,118,88,188,727
3,Darius Miles,1,SF,81,21,2133,318,630,0.505,1,19,0.053,317,611,0.519,0.506,124,238,0.521,127,350,477,99,51,125,147,191,761
3,Darius Miles,2,SF,82,6,2227,309,642,0.481,3,19,0.158,306,623,0.491,0.484,158,255,0.62,109,344,453,184,71,103,160,184,779
3,Darius Miles,3,SF,67,62,2008,263,642,0.41,0,14,0,263,628,0.419,0.41,92,155,0.594,113,250,363,176,67,69,178,159,618
3,Darius Miles,4,SF,79,56,2079,365,753,0.485,7,40,0.175,358,713,0.502,0.489,124,193,0.642,112,247,359,162,67,61,130,168,861
4,Marcus Fizer,1,PF,72,13,1580,278,646,0.43,10,39,0.256,268,607,0.442,0.438,117,161,0.727,76,237,313,76,30,19,124,175,683
4,Marcus Fizer,2,PF,76,20,1963,371,848,0.438,7,41,0.171,364,807,0.451,0.442,189,283,0.668,128,299,427,120,49,24,131,186,938
4,Marcus Fizer,3,PF,38,0,809,178,383,0.465,1,6,0.167,177,377,0.469,0.466,88,134,0.657,80,136,216,48,14,17,57,89,445
4,Marcus Fizer,4,SF,46,2,738,134,350,0.383,2,17,0.118,132,333,0.396,0.386,90,120,0.75,61,141,202,43,16,8,51,97,360
5,Mike Miller,1,SF,82,62,2390,368,845,0.436,148,364,0.407,220,481,0.457,0.523,91,128,0.711,66,261,327,140,51,19,97,200,975
5,Mike Miller,2,SF,63,53,2123,351,802,0.438,116,303,0.383,235,499,0.471,0.51,138,181,0.762,49,224,273,198,47,23,108,145,956
5,Mike Miller,3,SF,65,52,2186,373,859,0.434,109,300,0.363,264,559,0.472,0.498,156,186,0.839,46,295,341,170,42,21,125,173,1011
5,Mike Miller,4,SF,49,39,1826,296,708,0.418,87,256,0.34,209,452,0.462,0.48,127,150,0.847,40,246,286,139,36,16,99,139,806
6,DerMarr Johnson,1,SF,78,21,1313,146,390,0.374,41,127,0.323,105,263,0.399,0.427,64,87,0.736,56,122,178,64,43,30,93,134,397
6,DerMarr Johnson,2,SF,72,46,1727,214,540,0.396,89,247,0.36,125,293,0.427,0.479,85,105,0.81,59,188,247,81,62,56,102,163,602
6,DerMarr Johnson,3,SF,21,1,287,36,97,0.371,13,36,0.361,23,61,0.377,0.438,28,31,0.903,5,34,39,11,8,7,16,32,113
6,DerMarr Johnson,4,SG,71,40,1232,185,371,0.499,53,148,0.358,132,223,0.592,0.57,80,101,0.792,43,108,151,75,43,18,65,140,503
7,Chris Mihm,1,C,59,43,1166,173,391,0.442,0,1,0,173,390,0.444,0.442,100,126,0.794,106,174,280,16,20,53,80,156,446
7,Chris Mihm,2,C,74,60,1659,221,526,0.42,3,7,0.429,218,519,0.42,0.423,124,179,0.693,133,259,392,24,18,89,97,260,569
7,Chris Mihm,3,C,52,0,809,116,287,0.404,0,3,0,116,284,0.408,0.404,76,105,0.724,93,138,231,28,18,38,48,124,308
7,Chris Mihm,4,C-PF,76,17,1330,186,381,0.488,0,0,,186,381,0.488,0.488,110,166,0.663,156,257,413,21,37,63,90,208,482
8,Jamal Crawford,1,PG,61,8,1050,107,304,0.352,41,117,0.35,66,187,0.353,0.419,27,34,0.794,9,80,89,141,43,14,85,68,282
8,Jamal Crawford,2,PG,23,6,481,89,187,0.476,26,58,0.448,63,129,0.488,0.545,10,13,0.769,5,29,34,55,18,5,32,18,214
8,Jamal Crawford,3,PG,80,31,1992,334,808,0.413,86,242,0.355,248,566,0.438,0.467,104,129,0.806,21,164,185,334,77,25,134,126,858
8,Jamal Crawford,4,SG,80,73,2811,509,1318,0.386,165,521,0.317,344,797,0.432,0.449,200,240,0.833,46,237,283,405,111,29,193,161,1383
9,Joel Przybilla,1,C,33,13,270,12,35,0.343,0,0,,12,35,0.343,0.343,3,11,0.273,29,42,71,2,3,30,13,56,27
9,Joel Przybilla,2,C,71,62,1128,76,142,0.535,0,1,0,76,141,0.539,0.535,38,90,0.422,78,205,283,21,20,118,43,199,190
9,Joel Przybilla,3,C,32,17,546,18,46,0.391,0,0,,18,46,0.391,0.391,12,24,0.5,48,97,145,12,10,45,19,85,48
9,Joel Przybilla,4,C,17,12,347,18,50,0.36,0,0,,18,50,0.36,0.36,13,31,0.419,32,79,111,7,5,17,18,53,49
10,Keyon Dooling,1,PG,76,1,1237,148,362,0.409,28,80,0.35,120,282,0.426,0.448,125,179,0.698,8,81,89,177,41,11,94,107,449
10,Keyon Dooling,2,PG,14,0,155,22,57,0.386,4,14,0.286,18,43,0.419,0.421,10,12,0.833,0,3,3,12,4,3,10,20,58
10,Keyon Dooling,3,SG,55,1,969,128,329,0.389,50,139,0.36,78,190,0.411,0.465,44,57,0.772,9,63,72,89,24,6,60,93,350
10,Keyon Dooling,4,PG,58,24,1137,137,352,0.389,8,46,0.174,129,306,0.422,0.401,78,94,0.83,17,62,79,130,45,6,65,108,360
11,Jerome Moiso,1,C,24,0,135,12,30,0.4,0,1,0,12,29,0.414,0.4,11,26,0.423,12,30,42,3,3,4,18,29,35
11,Jerome Moiso,2,C,15,0,76,8,20,0.4,0,0,,8,20,0.4,0.4,0,0,,4,21,25,4,3,2,8,12,16
11,Jerome Moiso,3,C,51,1,644,89,171,0.52,0,0,,89,171,0.52,0.52,27,41,0.659,59,119,178,22,19,44,46,87,205
11,Jerome Moiso,4,PF,35,1,417,40,84,0.476,0,1,0,40,83,0.482,0.476,22,38,0.579,41,72,113,8,17,12,25,42,102
12,Etan Thomas,1,C,47,0,618,81,151,0.536,0,0,,81,151,0.536,0.536,41,74,0.554,55,126,181,6,17,35,26,76,203
12,Etan Thomas,2,PF,38,0,513,61,124,0.492,0,0,,61,124,0.492,0.492,60,94,0.638,70,95,165,3,8,23,33,66,182
12,Etan Thomas,3,C,79,15,1901,257,526,0.489,0,0,,257,526,0.489,0.489,191,295,0.647,183,345,528,68,36,123,113,219,705
12,Etan Thomas,4,C,47,10,976,128,255,0.502,0,0,,128,255,0.502,0.502,76,144,0.528,85,159,244,20,17,51,50,133,332
13,Courtney Alexander,1,PG,65,24,1382,239,573,0.417,17,46,0.37,222,527,0.421,0.432,123,150,0.82,42,101,143,62,45,5,75,139,618
13,Courtney Alexander,2,PG,38,6,472,62,178,0.348,3,10,0.3,59,168,0.351,0.357,33,45,0.733,20,43,63,21,16,3,21,76,160
13,Courtney Alexander,3,PG,27,18,910,177,395,0.448,14,36,0.389,163,359,0.454,0.466,90,105,0.857,22,58,80,41,29,2,54,63,458
13,Courtney Alexander,4,SG,56,28,1325,223,474,0.47,5,18,0.278,218,456,0.478,0.476,98,121,0.81,43,105,148,86,35,7,60,113,549
14,Mateen Cleaves,1,PG,78,8,1268,160,400,0.4,5,17,0.294,155,383,0.405,0.406,97,137,0.708,26,106,132,207,49,1,139,153,422
14,Mateen Cleaves,2,PG,32,0,153,30,68,0.441,2,8,0.25,28,60,0.467,0.456,8,9,0.889,1,7,8,25,7,0,27,9,70
14,Mateen Cleaves,3,PG,12,0,55,6,23,0.261,1,1,1,5,22,0.227,0.283,3,4,0.75,1,7,8,10,2,0,14,6,16
14,Mateen Cleaves,4,PG,4,2,92,7,23,0.304,0,1,0,7,22,0.318,0.304,1,2,0.5,1,6,7,19,4,2,5,13,15
15,Jason Collier,1,C,23,0,222,27,71,0.38,0,1,0,27,70,0.386,0.38,17,24,0.708,12,25,37,6,2,3,11,27,71
15,Jason Collier,2,C,25,2,365,41,95,0.432,0,1,0,41,94,0.436,0.432,24,32,0.75,31,51,82,9,6,4,13,40,106
15,Jason Collier,3,C,13,3,104,17,36,0.472,0,0,,17,36,0.472,0.472,2,2,1,12,17,29,1,2,1,2,10,36
15,Jason Collier,4,C,20,16,545,79,165,0.479,1,4,0.25,78,161,0.484,0.482,67,85,0.788,36,75,111,17,11,11,31,71,226
16,Hedo Turkoglu,1,SF,74,7,1245,138,335,0.412,28,86,0.326,110,249,0.442,0.454,87,112,0.777,49,161,210,69,52,24,55,139,391
16,Hedo Turkoglu,2,SF,80,10,1970,290,687,0.422,63,171,0.368,227,516,0.44,0.468,167,230,0.726,63,300,363,163,57,31,81,184,810
16,Hedo Turkoglu,3,SF,67,11,1175,165,391,0.422,29,78,0.372,136,313,0.435,0.459,88,110,0.8,35,153,188,87,25,12,50,125,447
16,Hedo Turkoglu,4,SF,80,44,2073,262,645,0.406,101,241,0.419,161,404,0.399,0.484,114,161,0.708,52,306,358,154,80,32,94,165,739
17,Desmond Mason,1,SF,78,14,1522,189,439,0.431,18,67,0.269,171,372,0.46,0.451,67,91,0.736,72,177,249,63,39,20,53,146,463
17,Desmond Mason,2,SF,75,20,2420,357,769,0.464,16,59,0.271,341,710,0.48,0.475,201,237,0.848,92,259,351,104,67,27,104,170,931
17,Desmond Mason,3,SF,80,40,2763,457,1017,0.449,21,72,0.292,436,945,0.461,0.46,212,283,0.749,154,369,523,163,67,32,115,210,1147
17,Desmond Mason,4,SF,52,15,1811,291,667,0.436,16,55,0.291,275,612,0.449,0.448,134,181,0.74,88,247,335,95,47,21,74,136,732
18,Quentin Richardson,1,SG,76,28,1358,232,525,0.442,50,151,0.331,182,374,0.487,0.49,99,158,0.627,105,152,257,62,42,7,64,98,613
18,Quentin Richardson,2,SG,81,0,2152,400,926,0.432,133,349,0.381,267,577,0.463,0.504,143,187,0.765,113,221,334,128,78,21,102,142,1076
18,Quentin Richardson,3,SG,59,13,1368,203,546,0.372,61,198,0.308,142,348,0.408,0.428,85,124,0.685,98,183,281,52,35,10,64,92,552
18,Quentin Richardson,4,SG,65,64,2338,425,1068,0.398,120,341,0.352,305,727,0.42,0.454,151,204,0.74,146,268,414,139,67,19,141,130,1121
19,Jamaal Magloire,1,C,74,0,1095,122,271,0.45,0,2,0,122,269,0.454,0.45,95,145,0.655,103,192,295,27,18,78,61,139,339
19,Jamaal Magloire,2,C,82,8,1549,228,414,0.551,0,1,0,228,413,0.552,0.551,243,333,0.73,153,308,461,31,27,86,118,201,699
19,Jamaal Magloire,3,C,82,82,2443,305,635,0.48,0,3,0,305,632,0.483,0.48,231,322,0.717,260,464,724,88,49,111,158,276,841
19,Jamaal Magloire,4,C,82,82,2777,383,809,0.473,0,1,0,383,808,0.474,0.473,353,470,0.751,268,579,847,86,43,101,201,278,1119
20,Speedy Claxton,1,PG,67,18,1528,181,452,0.4,4,33,0.121,177,419,0.422,0.405,114,136,0.838,46,114,160,198,95,6,95,145,480
20,Speedy Claxton,2,PG,30,0,471,67,145,0.462,0,11,0,67,134,0.5,0.462,39,57,0.684,22,34,56,75,22,7,35,43,173
20,Speedy Claxton,3,PG,60,29,1595,224,524,0.427,4,22,0.182,220,502,0.438,0.431,182,224,0.813,38,118,156,267,97,9,102,146,634
20,Speedy Claxton,4,PG,62,47,1866,257,611,0.421,11,61,0.18,246,550,0.447,0.43,187,254,0.736,37,147,184,374,109,8,119,184,712
21,Morris Peterson,1,SG,80,49,1809,290,673,0.431,63,165,0.382,227,508,0.447,0.478,104,145,0.717,112,147,259,105,63,20,78,164,747
21,Morris Peterson,2,SF,63,56,1988,336,768,0.438,84,231,0.364,252,537,0.469,0.492,127,169,0.751,91,132,223,153,73,11,86,174,883
21,Morris Peterson,3,SF,82,80,2949,421,1073,0.392,116,344,0.337,305,729,0.418,0.446,195,247,0.789,97,266,363,188,88,32,128,232,1153
21,Morris Peterson,4,SF,82,29,2148,238,587,0.405,126,340,0.371,112,247,0.453,0.513,76,94,0.809,35,226,261,113,88,14,69,206,678
22,Donnell Harvey,1,PF,18,0,65,8,14,0.571,0,0,,8,14,0.571,0.571,6,16,0.375,6,14,20,2,3,1,7,15,22
22,Donnell Harvey,2,PF,47,4,841,108,217,0.498,0,0,,108,217,0.498,0.498,54,90,0.6,80,147,227,37,21,24,33,115,270
22,Donnell Harvey,3,PF,18,0,162,14,26,0.538,0,0,,14,26,0.538,0.538,10,22,0.455,12,34,46,5,4,5,8,27,38
22,Donnell Harvey,4,PF,29,4,679,94,191,0.492,0,0,,94,191,0.492,0.492,44,68,0.647,68,113,181,32,17,19,25,88,232
23,DeShawn Stevenson,1,SG,40,2,293,31,91,0.341,1,12,0.083,30,79,0.38,0.346,26,38,0.684,9,19,28,18,10,2,28,29,89
23,DeShawn Stevenson,2,SG,67,23,1134,143,371,0.385,2,25,0.08,141,346,0.408,0.388,37,53,0.698,44,87,131,116,29,24,68,82,325
23,DeShawn Stevenson,3,SG,61,8,760,114,284,0.401,4,12,0.333,110,272,0.404,0.408,47,68,0.691,22,63,85,40,22,8,49,57,279
23,DeShawn Stevenson,4,SG-SF,80,78,2444,376,871,0.432,19,71,0.268,357,800,0.446,0.443,138,204,0.676,79,219,298,158,52,17,120,140,909
24,Dalibor Bagaric,1,C,35,0,259,17,65,0.262,0,1,0,17,64,0.266,0.262,13,28,0.464,22,34,56,10,9,16,21,44,47
24,Dalibor Bagaric,2,C,50,0,638,72,178,0.404,0,1,0,72,177,0.407,0.404,41,70,0.586,55,107,162,23,17,24,46,108,185
24,Dalibor Bagaric,3,C,10,0,76,8,26,0.308,0,0,,8,26,0.308,0.308,3,4,0.75,7,13,20,4,3,3,5,11,19
25,Jake Tsakalidis,1,C,57,39,947,101,215,0.47,0,0,,101,215,0.47,0.47,54,91,0.593,83,159,242,19,10,55,66,137,256
25,Jake Tsakalidis,2,C,67,47,1582,190,400,0.475,0,1,0,190,399,0.476,0.475,111,159,0.698,130,244,374,23,23,69,78,193,491
25,Jake Tsakalidis,3,C,33,27,543,61,135,0.452,0,0,,61,135,0.452,0.452,39,58,0.672,45,77,122,13,6,17,26,80,161
25,Jake Tsakalidis,4,C,40,28,533,67,133,0.504,0,0,,67,133,0.504,0.504,36,61,0.59,37,91,128,18,9,22,23,79,170
26,Mamadou N'Diaye,1,C,3,0,10,1,4,0.25,0,0,,1,4,0.25,0.25,2,2,1,1,1,2,0,0,0,0,3,4
26,Mamadou N'Diaye,2,C,5,0,46,6,10,0.6,0,0,,6,10,0.6,0.6,8,10,0.8,6,5,11,0,0,2,1,6,20
26,Mamadou N'Diaye,3,C,22,8,364,43,96,0.448,0,0,,43,96,0.448,0.448,34,47,0.723,29,53,82,7,8,32,21,58,120
26,Mamadou N'Diaye,4,C,28,1,366,27,69,0.391,0,0,,27,69,0.391,0.391,44,59,0.746,43,69,112,0,8,25,18,59,98
27,Primoz Brezec,1,C,22,4,160,14,29,0.483,0,0,,14,29,0.483,0.483,15,25,0.6,16,12,28,6,0,7,6,28,43
27,Primoz Brezec,2,C,22,1,111,15,38,0.395,0,1,0,15,37,0.405,0.395,12,20,0.6,13,10,23,4,2,4,7,16,42
27,Primoz Brezec,3,C,18,0,72,12,26,0.462,0,0,,12,26,0.462,0.462,4,6,0.667,5,10,15,3,0,3,6,13,28
27,Primoz Brezec,4,C,72,72,2276,387,756,0.512,0,0,,387,756,0.512,0.512,164,220,0.745,226,305,531,86,33,55,106,183,938
28,Erick Barkley,1,PG,8,0,38,8,22,0.364,3,8,0.375,5,14,0.357,0.432,0,0,,0,3,3,6,2,0,5,2,19
28,Erick Barkley,2,PG,19,4,228,24,68,0.353,1,7,0.143,23,61,0.377,0.36,9,10,0.9,5,13,18,34,17,1,12,29,58
29,Mark Madsen,1,PF,70,3,641,55,113,0.487,1,1,1,54,112,0.482,0.491,26,37,0.703,74,78,152,24,8,8,27,111,137
29,Mark Madsen,2,PF,59,5,650,66,146,0.452,0,2,0,66,144,0.458,0.452,35,54,0.648,89,73,162,44,16,13,22,104,167
29,Mark Madsen,3,PF,54,22,781,69,163,0.423,0,0,,69,163,0.423,0.423,36,61,0.59,86,73,159,38,15,19,27,116,174
29,Mark Madsen,4,C,72,12,1246,101,204,0.495,0,6,0,101,198,0.51,0.495,57,118,0.483,134,138,272,28,33,18,47,175,259
30,Marko Jaric,1,SF,66,12,1379,179,446,0.401,53,166,0.319,126,280,0.45,0.461,79,105,0.752,35,125,160,193,97,11,103,125,490
30,Marko Jaric,2,PG,58,50,1760,185,477,0.388,51,150,0.34,134,327,0.41,0.441,74,101,0.733,44,131,175,281,93,20,115,132,495
30,Marko Jaric,3,PG,50,41,1656,189,457,0.414,56,151,0.371,133,306,0.435,0.475,59,82,0.72,20,141,161,303,84,17,98,107,493
30,Marko Jaric,4,PG,75,49,2102,226,566,0.399,40,133,0.301,186,433,0.43,0.435,95,138,0.688,60,173,233,293,108,21,127,189,587
31,Dan Langhi,1,SF,33,0,241,37,99,0.374,0,1,0,37,98,0.378,0.374,16,29,0.552,13,28,41,4,7,1,8,16,90
31,Dan Langhi,2,SF,34,8,434,49,125,0.392,1,4,0.25,48,121,0.397,0.396,8,11,0.727,22,45,67,14,8,5,9,25,107
31,Dan Langhi,3,SF,60,0,541,81,202,0.401,9,31,0.29,72,171,0.421,0.423,12,20,0.6,19,68,87,21,15,6,16,58,183
31,Dan Langhi,4,SF,6,0,37,5,14,0.357,1,2,0.5,4,12,0.333,0.393,2,2,1,0,4,4,0,0,0,2,7,13
32,A.J. Guyton,1,PG,33,8,630,78,192,0.406,27,69,0.391,51,123,0.415,0.477,15,18,0.833,10,26,36,64,9,5,24,35,198
32,A.J. Guyton,2,PG,45,6,607,88,244,0.361,46,123,0.374,42,121,0.347,0.455,22,27,0.815,12,32,44,81,10,7,37,23,244
32,A.J. Guyton,3,PG,2,0,9,0,4,0,0,1,0,0,3,0,0,0,0,,0,0,0,2,1,0,1,0,0
33,Jake Voskuhl,1,C,16,2,143,11,25,0.44,0,0,,11,25,0.44,0.44,8,14,0.571,12,22,34,5,5,6,12,38,30
33,Jake Voskuhl,2,C,59,34,900,107,193,0.554,0,0,,107,193,0.554,0.554,82,109,0.752,103,147,250,18,11,23,48,139,296
33,Jake Voskuhl,3,C,65,1,947,92,163,0.564,0,0,,92,163,0.564,0.564,64,96,0.667,97,128,225,36,18,29,48,172,248
33,Jake Voskuhl,4,C,66,43,1606,152,300,0.507,0,0,,152,300,0.507,0.507,134,181,0.74,123,220,343,57,42,25,77,258,438
34,Khalid El-Amin,1,PG,50,14,936,115,311,0.37,28,84,0.333,87,227,0.383,0.415,56,72,0.778,21,60,81,145,48,2,54,99,314
35,Mike Smith,1,SF,17,0,180,19,59,0.322,3,18,0.167,16,41,0.39,0.347,10,16,0.625,10,12,22,10,5,3,7,8,51
36,Soumaila Samake,1,C,34,0,226,18,48,0.375,0,0,,18,48,0.375,0.375,10,24,0.417,22,31,53,1,2,14,4,23,46
36,Soumaila Samake,2,C,13,1,77,10,24,0.417,0,0,,10,24,0.417,0.417,2,2,1,10,13,23,4,0,5,2,13,22
37,Eddie House,1,PG,50,0,550,104,247,0.421,19,55,0.345,85,192,0.443,0.46,24,35,0.686,5,37,42,52,13,0,35,58,251
37,Eddie House,2,PG,64,3,1230,209,524,0.399,54,157,0.344,155,367,0.422,0.45,42,49,0.857,17,93,110,123,43,5,80,98,514
37,Eddie House,3,SG,55,7,1025,172,444,0.387,36,120,0.3,136,324,0.42,0.428,31,36,0.861,17,84,101,87,44,1,46,73,411
37,Eddie House,4,SG,60,10,1188,161,449,0.359,51,136,0.375,110,313,0.351,0.415,36,45,0.8,28,110,138,148,65,4,63,92,409
38,Eduardo Najera,1,PF,40,4,431,58,111,0.523,1,3,0.333,57,108,0.528,0.527,14,33,0.424,41,54,95,27,13,8,17,48,131
38,Eduardo Najera,2,PF,62,11,1357,150,300,0.5,0,2,0,150,298,0.503,0.5,100,148,0.676,149,193,342,38,56,30,40,156,400
38,Eduardo Najera,3,SF,48,12,1103,129,231,0.558,0,1,0,129,230,0.561,0.558,62,91,0.681,90,133,223,47,40,22,23,129,320
38,Eduardo Najera,4,SF,58,7,720,72,162,0.444,2,4,0.5,70,158,0.443,0.451,30,46,0.652,67,89,156,25,35,19,29,90,176
39,Lavor Postell,1,SG,26,0,169,17,54,0.315,3,11,0.273,14,43,0.326,0.343,22,27,0.815,8,17,25,5,4,2,17,12,59
39,Lavor Postell,2,SG,23,0,179,28,84,0.333,6,26,0.231,22,58,0.379,0.369,31,41,0.756,2,14,16,5,6,0,11,7,93
39,Lavor Postell,3,SG,12,0,98,14,38,0.368,2,7,0.286,12,31,0.387,0.395,13,15,0.867,1,3,4,3,2,0,7,9,43
40,Hanno Mottola,1,SF,73,3,989,123,277,0.444,0,3,0,123,274,0.449,0.444,73,90,0.811,49,125,174,25,11,9,67,163,319
40,Hanno Mottola,2,C,82,14,1371,169,384,0.44,1,13,0.077,168,371,0.453,0.441,57,76,0.75,81,187,268,50,20,19,70,174,396
41,Chris Carrawell,No NBA Data,,,,,,,,,,,,,,,,,,,,,,,,,,
42,Olumide Oyedeji,1,C,30,1,221,18,37,0.486,0,0,,18,37,0.486,0.486,9,12,0.75,24,43,67,2,7,10,11,40,45
42,Olumide Oyedeji,2,C,36,1,221,22,41,0.537,0,0,,22,41,0.537,0.537,11,18,0.611,27,52,79,4,4,2,14,36,55
42,Olumide Oyedeji,3,C,27,3,145,10,23,0.435,0,0,,10,23,0.435,0.435,7,11,0.636,10,40,50,5,5,3,5,30,27
43,Michael Redd,1,SG,6,0,35,5,19,0.263,0,3,0,5,16,0.313,0.263,3,6,0.5,3,1,4,1,1,0,1,2,13
43,Michael Redd,2,SG,67,8,1417,294,609,0.483,88,198,0.444,206,411,0.501,0.555,91,115,0.791,77,147,224,91,42,7,57,96,767
43,Michael Redd,3,SG,82,14,2316,455,971,0.469,182,416,0.438,273,555,0.492,0.562,149,185,0.805,98,273,371,117,100,13,74,143,1241
43,Michael Redd,4,SG,82,82,3021,633,1439,0.44,127,363,0.35,506,1076,0.47,0.484,383,441,0.868,118,289,407,185,81,6,116,152,1776
44,Brian Cardinal,1,PF,15,0,126,10,31,0.323,0,5,0,10,26,0.385,0.323,11,18,0.611,8,15,23,3,7,2,9,27,31
44,Brian Cardinal,2,PF,8,0,43,6,13,0.462,3,7,0.429,3,6,0.5,0.577,2,2,1,2,4,6,2,1,0,0,5,17
44,Brian Cardinal,3,PF,5,0,15,1,4,0.25,0,1,0,1,3,0.333,0.25,2,2,1,3,2,5,1,0,0,1,0,4
44,Brian Cardinal,4,PF,76,11,1634,220,466,0.472,55,124,0.444,165,342,0.482,0.531,238,271,0.878,100,217,317,103,66,20,84,206,733
45,Jabari Smith,1,C,9,0,66,11,22,0.5,0,0,,11,22,0.5,0.5,4,6,0.667,1,7,8,6,4,0,3,7,26
45,Jabari Smith,2,C,23,0,181,26,63,0.413,0,3,0,26,60,0.433,0.413,21,32,0.656,8,20,28,11,6,6,5,31,73
45,Jabari Smith,3,C,12,0,71,6,21,0.286,0,1,0,6,20,0.3,0.286,6,12,0.5,2,12,14,6,2,4,2,12,18
45,Jabari Smith,4,C,11,0,110,20,42,0.476,0,2,0,20,40,0.5,0.476,15,20,0.75,6,8,14,5,4,2,3,19,55
46,DeeAndre Hulett,No NBA Data,,,,,,,,,,,,,,,,,,,,,,,,,,
47,Josip Sesar,No NBA Data,,,,,,,,,,,,,,,,,,,,,,,,,,
48,Mark Karcher,No NBA Data,,,,,,,,,,,,,,,,,,,,,,,,,,
49,Jason Hart,1,PG,1,0,10,1,1,1,0,0,,1,1,1,1,0,0,,0,0,0,1,0,0,2,0,2
49,Jason Hart,2,PG,10,0,92,10,19,0.526,0,2,0,10,17,0.588,0.526,6,6,1,4,9,13,12,7,1,8,16,26
49,Jason Hart,3,PG,53,5,660,71,159,0.447,2,9,0.222,69,150,0.46,0.453,33,43,0.767,10,69,79,81,28,5,29,59,177
49,Jason Hart,4,PG,74,27,1887,257,573,0.449,35,95,0.368,222,478,0.464,0.479,157,200,0.785,18,185,203,367,99,14,102,167,706
50,Kaniel Dickens,1,PF,3,0,12,3,3,1,0,0,,3,3,1,1,1,2,0.5,2,0,2,0,0,0,1,3,7
50,Kaniel Dickens,2,SF,11,0,61,4,14,0.286,3,9,0.333,1,5,0.2,0.393,2,2,1,3,6,9,1,2,1,2,5,13
50,Kaniel Dickens,3,PF,5,0,12,1,3,0.333,0,0,,1,3,0.333,0.333,0,0,,0,1,1,1,0,1,0,1,2
51,Igor Rakocevic,1,PG,42,0,244,22,58,0.379,5,12,0.417,17,46,0.37,0.422,29,36,0.806,4,13,17,33,4,0,23,25,78
52,Ernest Brown,1,C,3,0,21,1,6,0.167,0,0,,1,6,0.167,0.167,1,4,0.25,1,5,6,0,0,1,3,4,3
53,Dan McClintock,1,C,6,1,58,9,18,0.5,0,0,,9,18,0.5,0.5,0,5,0,10,7,17,1,0,2,3,11,18
54,Cory Hightower,No NBA Data,,,,,,,,,,,,,,,,,,,,,,,,,,
55,Chris Porter,1,SF,51,35,1147,173,445,0.389,0,5,0,173,440,0.393,0.389,94,141,0.667,89,100,189,61,45,6,59,111,440
56,Jaquay Walls,No NBA Data,,,,,,,,,,,,,,,,,,,,,,,,,,
57,Scoonie Penn,No NBA Data,,,,,,,,,,,,,,,,,,,,,,,,,,
58,Pete Mickeal,No NBA Data,,,,,,,,,,,,,,,,,,,,,,,,,,
59,Kwame Brown,1,PF,57,3,817,94,243,0.387,0,1,0,94,242,0.388,0.387,70,99,0.707,63,135,198,43,16,26,43,105,258
59,Kwame Brown,2,C,80,20,1773,224,502,0.446,0,3,0,224,499,0.449,0.446,145,217,0.668,128,298,426,58,50,80,110,159,593
59,Kwame Brown,3,PF,74,57,2239,288,589,0.489,1,2,0.5,287,587,0.489,0.49,228,334,0.683,178,372,550,112,66,52,140,144,805
59,Kwame Brown,4,PF,42,14,908,109,237,0.46,0,0,,109,237,0.46,0.46,74,129,0.574,72,134,206,39,25,15,67,112,292
60,Tyson Chandler,1,C,71,31,1389,151,304,0.497,0,0,,151,304,0.497,0.497,134,222,0.604,114,229,343,54,28,93,99,179,436
60,Tyson Chandler,2,C,75,68,1827,257,484,0.531,0,0,,257,484,0.531,0.531,177,291,0.608,169,345,514,76,37,106,135,220,691
60,Tyson Chandler,3,PF,35,8,782,67,158,0.424,0,1,0,67,157,0.427,0.424,79,118,0.669,82,188,270,23,17,43,38,87,213
60,Tyson Chandler,4,C,80,10,2189,207,419,0.494,0,2,0,207,417,0.496,0.494,226,336,0.673,261,514,775,65,69,141,118,268,640
61,Pau Gasol,1,C,82,79,3007,551,1064,0.518,1,5,0.2,550,1059,0.519,0.518,338,477,0.709,238,492,730,223,41,169,224,195,1441
61,Pau Gasol,2,PF,82,82,2948,569,1116,0.51,1,10,0.1,568,1106,0.514,0.51,416,565,0.736,192,528,720,229,34,148,213,220,1555
61,Pau Gasol,3,PF,78,78,2458,506,1049,0.482,4,15,0.267,502,1034,0.485,0.484,365,511,0.714,206,394,600,198,44,132,187,185,1381
61,Pau Gasol,4,PF,56,53,1790,357,695,0.514,1,6,0.167,356,689,0.517,0.514,282,367,0.768,130,280,410,135,37,93,137,146,997
62,Eddy Curry,1,C,72,31,1150,189,377,0.501,0,0,,189,377,0.501,0.501,105,160,0.656,111,161,272,25,16,53,69,173,483
62,Eddy Curry,2,C,81,48,1571,335,573,0.585,0,0,,335,573,0.585,0.585,179,287,0.624,116,237,353,37,18,62,137,226,849
62,Eddy Curry,3,PF,73,63,2154,417,840,0.496,1,1,1,416,839,0.496,0.497,235,350,0.671,143,308,451,68,24,83,177,258,1070
62,Eddy Curry,4,C,63,60,1808,393,730,0.538,0,0,,393,730,0.538,0.538,226,314,0.72,116,222,338,37,21,58,163,202,1012
63,Jason Richardson,1,SG,80,75,2629,464,1090,0.426,82,246,0.333,382,844,0.453,0.463,141,210,0.671,124,216,340,236,106,31,160,195,1151
63,Jason Richardson,2,SG,82,82,2698,476,1161,0.41,123,334,0.368,353,827,0.427,0.463,207,271,0.764,111,267,378,247,90,23,179,201,1282
63,Jason Richardson,3,SG,78,78,2936,563,1284,0.438,77,273,0.282,486,1011,0.481,0.468,258,377,0.684,124,400,524,226,86,41,196,182,1461
63,Jason Richardson,4,SG,72,72,2724,610,1368,0.446,125,370,0.338,485,998,0.486,0.492,214,309,0.693,125,299,424,281,105,32,169,156,1559
64,Shane Battier,1,SF,78,78,3097,412,961,0.429,103,276,0.373,309,685,0.451,0.482,198,283,0.7,180,238,418,216,121,81,155,215,1125
64,Shane Battier,2,SF,78,47,2383,275,569,0.483,86,216,0.398,189,353,0.535,0.559,120,145,0.828,128,217,345,105,102,88,68,207,756
64,Shane Battier,3,SF,79,1,1947,242,543,0.446,65,186,0.349,177,357,0.496,0.506,120,164,0.732,102,201,303,101,101,58,56,187,669
64,Shane Battier,4,SG,80,72,2516,271,613,0.442,70,177,0.395,201,436,0.461,0.499,180,228,0.789,158,255,413,126,91,77,75,201,792
65,Eddie Griffin,1,PF,73,24,1896,244,666,0.366,90,273,0.33,154,393,0.392,0.434,64,86,0.744,117,299,416,53,17,134,47,117,642
65,Eddie Griffin,2,PF,77,66,1890,271,678,0.4,64,192,0.333,207,486,0.426,0.447,58,94,0.617,138,323,461,86,52,111,76,136,664
65,Eddie Griffin,3,PF,70,0,1492,202,522,0.387,67,204,0.328,135,318,0.425,0.451,56,78,0.718,128,325,453,53,23,118,55,120,527
65,Eddie Griffin,4,C,70,27,1359,130,370,0.351,16,82,0.195,114,288,0.396,0.373,44,74,0.595,107,282,389,40,13,148,43,125,320
66,DeSagana Diop,1,C,18,1,109,12,29,0.414,0,0,,12,29,0.414,0.414,1,5,0.2,5,12,17,5,1,10,12,19,25
66,DeSagana Diop,2,PF,80,1,943,54,154,0.351,0,0,,54,154,0.351,0.351,11,30,0.367,63,152,215,43,33,81,56,148,119
66,DeSagana Diop,3,C,56,3,730,57,147,0.388,0,0,,57,147,0.388,0.388,12,20,0.6,72,127,199,34,26,51,29,116,126
66,DeSagana Diop,4,C,39,0,306,20,69,0.29,0,2,0,20,67,0.299,0.29,0,5,0,30,40,70,15,8,27,12,53,40
67,Rodney White,1,SF,16,0,129,21,60,0.35,2,9,0.222,19,51,0.373,0.367,12,14,0.857,2,16,18,12,9,2,14,6,56
67,Rodney White,2,SG,72,19,1563,260,638,0.408,32,134,0.239,228,504,0.452,0.433,98,125,0.784,43,170,213,121,45,32,156,134,650
67,Rodney White,3,SF,72,0,985,215,468,0.459,33,87,0.379,182,381,0.478,0.495,78,104,0.75,44,121,165,60,32,20,78,105,541
67,Rodney White,4,SF,58,2,677,121,289,0.419,24,60,0.4,97,229,0.424,0.46,27,44,0.614,24,65,89,44,32,11,37,64,293
68,Joe Johnson,1,SG,77,60,1916,251,584,0.43,38,130,0.292,213,454,0.469,0.462,41,53,0.774,75,182,257,179,59,20,71,114,581
68,Joe Johnson,2,SG,48,33,1003,130,296,0.439,24,88,0.273,106,208,0.51,0.48,20,26,0.769,40,99,139,74,33,9,28,59,304
68,Joe Johnson,3,SG,29,27,913,121,288,0.42,14,42,0.333,107,246,0.435,0.444,21,27,0.778,35,83,118,105,26,11,43,55,277
68,Joe Johnson,4,SG,82,34,2255,316,796,0.397,75,205,0.366,241,591,0.408,0.444,96,124,0.774,57,207,264,210,62,19,108,143,803
69,Kedrick Brown,1,SF,29,5,245,23,70,0.329,5,27,0.185,18,43,0.419,0.364,12,20,0.6,11,39,50,15,18,7,7,18,63
69,Kedrick Brown,2,SF,51,5,666,61,171,0.357,3,39,0.077,58,132,0.439,0.365,20,32,0.625,45,95,140,20,34,13,23,68,145
69,Kedrick Brown,3,SF,55,26,969,117,254,0.461,38,99,0.384,79,155,0.51,0.535,17,27,0.63,41,105,146,64,30,7,29,80,289
69,Kedrick Brown,4,SF,21,10,408,45,99,0.455,12,32,0.375,33,67,0.493,0.515,8,13,0.615,18,50,68,25,17,2,12,38,110
70,Vladimir Radmanovic,1,PF,61,16,1230,146,354,0.412,66,157,0.42,80,197,0.406,0.506,49,72,0.681,45,185,230,81,56,24,72,119,407
70,Vladimir Radmanovic,2,PF,72,16,1910,274,668,0.41,104,293,0.355,170,375,0.453,0.488,72,102,0.706,76,247,323,97,64,22,100,136,724
70,Vladimir Radmanovic,3,PF,77,38,2321,345,812,0.425,140,377,0.371,205,435,0.471,0.511,95,127,0.748,104,302,406,142,80,42,109,187,925
70,Vladimir Radmanovic,4,PF,63,0,1856,266,650,0.409,128,329,0.389,138,321,0.43,0.508,81,103,0.786,52,237,289,86,57,31,80,172,741
71,Richard Jefferson,1,SF,79,9,1917,270,591,0.457,13,56,0.232,257,535,0.48,0.468,189,265,0.713,85,208,293,140,64,48,107,211,742
71,Richard Jefferson,2,SF,80,80,2879,456,911,0.501,6,24,0.25,450,887,0.507,0.504,324,436,0.743,150,364,514,201,80,44,156,216,1242
71,Richard Jefferson,3,SF,82,82,3133,555,1115,0.498,48,132,0.364,507,983,0.516,0.519,357,468,0.763,109,355,464,315,92,28,198,224,1515
71,Richard Jefferson,4,SF,33,33,1355,238,564,0.422,30,89,0.337,208,475,0.438,0.449,227,269,0.844,49,191,240,133,33,17,132,109,733
72,Troy Murphy,1,PF,82,4,1448,178,423,0.421,3,9,0.333,175,414,0.423,0.424,121,156,0.776,99,223,322,70,36,21,84,217,480
72,Troy Murphy,2,PF,79,79,2510,338,749,0.451,3,14,0.214,335,735,0.456,0.453,244,290,0.841,228,578,806,106,65,30,111,246,923
72,Troy Murphy,3,PF,28,0,610,107,243,0.44,5,17,0.294,102,226,0.451,0.451,60,80,0.75,48,125,173,20,12,17,34,58,279
72,Troy Murphy,4,PF,70,69,2375,392,947,0.414,59,148,0.399,333,799,0.417,0.445,233,319,0.73,251,505,756,97,53,33,108,190,1076
73,Steven Hunter,1,C,53,21,516,67,147,0.456,0,0,,67,147,0.456,0.456,55,94,0.585,40,57,97,5,5,43,16,81,189
73,Steven Hunter,2,C,33,5,447,56,103,0.544,0,0,,56,103,0.544,0.544,18,44,0.409,38,55,93,6,9,36,15,56,130
73,Steven Hunter,3,C,59,23,789,82,155,0.529,0,0,,82,155,0.529,0.529,23,69,0.333,54,116,170,12,5,73,29,101,187
73,Steven Hunter,4,C,76,3,1046,135,220,0.614,0,1,0,135,219,0.616,0.614,78,163,0.479,98,129,227,13,4,102,44,131,348
74,Kirk Haston,1,PF,15,0,77,11,39,0.282,0,3,0,11,36,0.306,0.282,4,8,0.5,5,15,20,5,0,1,3,9,26
74,Kirk Haston,2,SF,12,0,57,2,17,0.118,0,3,0,2,14,0.143,0.118,2,4,0.5,0,7,7,3,0,5,7,10,6
75,Michael Bradley,1,PF,26,0,118,13,25,0.52,0,2,0,13,23,0.565,0.52,4,8,0.5,7,17,24,3,0,6,6,10,30
75,Michael Bradley,2,PF,67,11,1314,151,314,0.481,1,6,0.167,150,308,0.487,0.482,35,67,0.522,162,247,409,67,16,32,76,125,338
75,Michael Bradley,3,C-PF,16,1,98,7,15,0.467,0,0,,7,15,0.467,0.467,1,2,0.5,6,17,23,1,3,0,7,14,15
75,Michael Bradley,4,PF,5,0,38,1,3,0.333,0,0,,1,3,0.333,0.333,1,2,0.5,1,10,11,1,1,0,3,6,3
76,Jason Collins,1,C,77,9,1407,117,278,0.421,1,2,0.5,116,276,0.42,0.423,115,164,0.701,132,169,301,81,29,47,72,173,350
76,Jason Collins,2,C,81,66,1900,140,338,0.414,0,4,0,140,334,0.419,0.414,180,236,0.763,136,232,368,87,47,44,85,252,460
76,Jason Collins,3,C,78,78,2220,163,384,0.424,0,2,0,163,382,0.427,0.424,136,184,0.739,143,257,400,153,67,56,97,251,462
76,Jason Collins,4,C,80,80,2542,186,451,0.412,2,6,0.333,184,445,0.413,0.415,137,209,0.656,153,335,488,105,71,71,91,322,511
77,Zach Randolph,1,PF,41,0,238,48,107,0.449,0,0,,48,107,0.449,0.449,18,27,0.667,31,38,69,13,7,4,15,29,114
77,Zach Randolph,2,PF,77,11,1301,264,515,0.513,0,5,0,264,510,0.518,0.513,122,161,0.758,139,204,343,41,42,14,62,141,650
77,Zach Randolph,3,PF,81,80,3067,663,1368,0.485,1,5,0.2,662,1363,0.486,0.485,299,393,0.761,242,609,851,163,68,41,247,227,1626
77,Zach Randolph,4,PF,46,37,1603,332,741,0.448,0,6,0,332,735,0.452,0.448,207,254,0.815,142,300,442,86,34,17,112,112,871
78,Brendan Haywood,1,C,62,2,1266,109,221,0.493,0,0,,109,221,0.493,0.493,97,160,0.606,143,179,322,29,21,91,50,158,315
78,Brendan Haywood,2,C,81,69,1930,173,339,0.51,0,0,,173,339,0.51,0.51,155,245,0.633,192,212,404,29,32,119,65,225,501
78,Brendan Haywood,3,C,77,59,1484,200,388,0.515,0,1,0,200,387,0.517,0.515,137,234,0.585,186,201,387,43,32,100,80,154,537
78,Brendan Haywood,4,C,68,68,1865,239,427,0.56,0,0,,239,427,0.56,0.56,159,261,0.609,202,262,464,57,52,114,96,218,637
79,Joseph Forte,1,SG,8,0,39,1,12,0.083,0,3,0,1,9,0.111,0.083,4,4,1,1,5,6,6,2,0,3,1,6
79,Joseph Forte,2,SG,17,0,86,10,35,0.286,0,3,0,10,32,0.313,0.286,4,6,0.667,4,7,11,11,4,0,10,6,24
80,Jeryl Sasser,1,SG,7,0,36,3,14,0.214,0,0,,3,14,0.214,0.214,4,5,0.8,3,4,7,2,3,0,2,3,10
80,Jeryl Sasser,2,SG,75,4,1025,64,207,0.309,13,44,0.295,51,163,0.313,0.341,53,78,0.679,64,120,184,65,45,12,39,91,194
81,Brandon Armstrong,1,SG,35,0,196,27,85,0.318,5,17,0.294,22,68,0.324,0.347,5,10,0.5,10,6,16,8,7,1,8,26,64
81,Brandon Armstrong,2,SG,17,0,69,9,27,0.333,1,6,0.167,8,21,0.381,0.352,5,6,0.833,0,4,4,2,3,1,5,8,24
81,Brandon Armstrong,3,SG,56,0,434,65,175,0.371,19,52,0.365,46,123,0.374,0.426,2,4,0.5,12,31,43,14,12,2,24,49,151
82,Raul Lopez,1,PG,82,11,1617,223,517,0.431,25,85,0.294,198,432,0.458,0.456,101,117,0.863,24,131,155,305,62,2,174,200,572
82,Raul Lopez,2,PG,31,15,518,57,135,0.422,20,45,0.444,37,90,0.411,0.496,27,33,0.818,7,32,39,123,22,3,47,78,161
83,Gerald Wallace,1,SF,54,1,430,75,175,0.429,0,7,0,75,168,0.446,0.429,23,46,0.5,49,40,89,27,19,6,22,46,173
83,Gerald Wallace,2,SF,47,7,571,90,183,0.492,1,4,0.25,89,179,0.497,0.495,39,74,0.527,38,90,128,23,24,15,44,68,220
83,Gerald Wallace,3,SF,37,1,337,32,89,0.36,0,2,0,32,87,0.368,0.36,11,24,0.458,35,39,74,19,14,14,8,37,75
83,Gerald Wallace,4,SF,70,68,2147,286,637,0.449,17,62,0.274,269,575,0.468,0.462,191,289,0.661,118,268,386,137,117,91,159,182,780
84,Samuel Dalembert,1,C,34,0,177,22,50,0.44,0,0,,22,50,0.44,0.44,7,18,0.389,25,43,68,5,6,13,14,30,51
84,Samuel Dalembert,2,C,82,53,2197,270,499,0.541,0,1,0,270,498,0.542,0.541,112,174,0.644,194,432,626,21,44,189,86,273,652
84,Samuel Dalembert,3,C,72,60,1785,250,477,0.524,0,0,,250,477,0.524,0.524,89,148,0.601,187,355,542,35,46,121,114,241,589
84,Samuel Dalembert,4,C,66,52,1761,196,369,0.531,0,1,0,196,368,0.533,0.531,93,132,0.705,159,382,541,25,34,160,107,244,485
85,Jamaal Tinsley,1,PG,80,78,2442,289,760,0.38,42,175,0.24,247,585,0.422,0.408,131,186,0.704,78,220,298,647,138,40,270,248,751
85,Jamaal Tinsley,2,PG,73,69,2237,220,556,0.396,46,166,0.277,174,390,0.446,0.437,80,112,0.714,58,202,260,548,125,18,192,201,566
85,Jamaal Tinsley,3,PG,52,43,1378,153,370,0.414,77,207,0.372,76,163,0.466,0.518,49,67,0.731,28,108,136,303,84,17,110,132,432
85,Jamaal Tinsley,4,PG,40,40,1301,218,522,0.418,58,156,0.372,160,366,0.437,0.473,122,164,0.744,26,134,160,257,81,12,134,112,616
86,Tony Parker,1,PG,77,72,2267,268,639,0.419,61,189,0.323,207,450,0.46,0.467,108,160,0.675,33,164,197,334,89,7,151,166,705
86,Tony Parker,2,PG,82,82,2774,484,1043,0.464,82,243,0.337,402,800,0.503,0.503,219,290,0.755,33,183,216,432,71,4,198,174,1269
86,Tony Parker,3,PG,75,75,2577,423,946,0.447,62,199,0.312,361,747,0.483,0.48,191,272,0.702,43,194,237,411,61,7,179,148,1099
86,Tony Parker,4,PG,80,80,2735,539,1118,0.482,43,156,0.276,496,962,0.516,0.501,210,323,0.65,47,251,298,491,98,4,215,167,1331
87,Trenton Hassell,1,SG,78,47,2237,267,628,0.425,60,165,0.364,207,463,0.447,0.473,87,114,0.763,65,190,255,172,55,44,101,184,681
87,Trenton Hassell,2,SG,82,53,1999,144,392,0.367,13,40,0.325,131,352,0.372,0.384,41,55,0.745,37,218,255,151,45,61,83,197,342
87,Trenton Hassell,3,SG,81,74,2264,177,381,0.465,4,13,0.308,173,368,0.47,0.47,48,61,0.787,68,189,257,133,36,54,46,200,406
87,Trenton Hassell,4,SG,82,51,2068,225,475,0.474,1,11,0.091,224,464,0.483,0.475,90,114,0.789,80,139,219,128,30,30,64,200,541
88,Gilbert Arenas,1,PG,47,30,1155,174,384,0.453,39,113,0.345,135,271,0.498,0.504,124,160,0.775,41,91,132,174,69,11,97,115,511
88,Gilbert Arenas,2,PG,82,82,2866,509,1180,0.431,109,313,0.348,400,867,0.461,0.478,370,468,0.791,97,289,386,514,124,17,290,260,1497
88,Gilbert Arenas,3,PG,55,52,2066,358,914,0.392,125,333,0.375,233,581,0.401,0.46,237,317,0.748,55,199,254,275,103,12,226,176,1078
88,Gilbert Arenas,4,PG,80,80,3274,656,1523,0.431,205,562,0.365,451,961,0.469,0.498,521,640,0.814,83,295,378,411,139,23,242,245,2038
89,Omar Cook,1,PG,17,0,139,7,27,0.259,0,1,0,7,26,0.269,0.259,0,0,,3,3,6,24,10,0,10,14,14
89,Omar Cook,2,PG,5,0,74,10,24,0.417,0,4,0,10,20,0.5,0.417,3,6,0.5,2,5,7,22,6,1,6,6,23
90,Will Solomon,1,SG,62,4,872,113,331,0.341,46,162,0.284,67,169,0.396,0.411,49,73,0.671,12,56,68,92,35,7,62,76,321
90,Will Solomon,2,PG,53,9,712,105,245,0.429,28,86,0.326,77,159,0.484,0.486,25,34,0.735,12,52,64,133,27,4,54,71,263
90,Will Solomon,3,PG,39,9,544,79,181,0.436,15,57,0.263,64,124,0.516,0.478,20,24,0.833,9,34,43,123,20,4,49,60,193
90,Will Solomon,4,PG,14,0,168,26,64,0.406,13,29,0.448,13,35,0.371,0.508,5,10,0.5,3,18,21,10,7,0,5,11,70
91,Terence Morris,1,SF,68,12,1110,111,289,0.384,15,78,0.192,96,211,0.455,0.41,18,28,0.643,77,134,211,64,21,27,45,72,255
91,Terence Morris,2,SF,49,0,632,82,176,0.466,7,32,0.219,75,144,0.521,0.486,11,14,0.786,40,88,128,25,8,17,29,35,182
91,Terence Morris,3,SF,22,0,192,16,49,0.327,0,2,0,16,47,0.34,0.327,3,3,1,6,32,38,4,6,5,7,19,35
92,Brian Scalabrine,1,PF,28,0,290,23,67,0.343,3,10,0.3,20,57,0.351,0.366,11,15,0.733,12,39,51,21,9,2,24,39,60
92,Brian Scalabrine,2,PF,59,7,724,68,169,0.402,14,39,0.359,54,130,0.415,0.444,30,36,0.833,40,101,141,46,16,18,46,77,180
92,Brian Scalabrine,3,PF,69,2,928,86,218,0.394,10,41,0.244,76,177,0.429,0.417,58,70,0.829,42,131,173,65,21,14,42,113,240
92,Brian Scalabrine,4,PF,54,14,1167,132,332,0.398,22,68,0.324,110,264,0.417,0.431,53,69,0.768,83,161,244,88,34,18,66,111,339
93,Jeff Trepagnier,1,SG,12,0,77,7,23,0.304,0,1,0,7,22,0.318,0.304,4,7,0.571,3,9,12,12,8,4,11,8,18
93,Jeff Trepagnier,2,SG,8,0,97,17,40,0.425,4,8,0.5,13,32,0.406,0.475,7,7,1,8,8,16,6,8,0,8,5,45
93,Jeff Trepagnier,3,SG,11,0,96,10,38,0.263,2,4,0.5,8,34,0.235,0.289,3,6,0.5,6,9,15,4,3,0,6,7,25
94,Damone Brown,1,SF,17,0,67,8,21,0.381,0,1,0,8,20,0.4,0.381,7,8,0.875,2,2,4,2,1,1,9,11,23
94,Damone Brown,2,PF,5,3,115,11,35,0.314,0,2,0,11,33,0.333,0.314,6,8,0.75,3,12,15,3,1,0,6,14,28
94,Damone Brown,3,PF,3,0,17,1,10,0.1,0,0,,1,10,0.1,0.1,1,2,0.5,3,2,5,0,2,0,1,2,3
94,Damone Brown,4,SF,14,0,152,23,62,0.371,4,11,0.364,19,51,0.373,0.403,4,9,0.444,10,18,28,14,1,6,15,17,54
95,Mehmet Okur,1,PF,72,9,1366,180,423,0.426,38,112,0.339,142,311,0.457,0.47,96,131,0.733,117,218,335,71,25,39,66,167,494
95,Mehmet Okur,2,PF,71,33,1580,251,542,0.463,18,48,0.375,233,494,0.472,0.48,162,209,0.775,160,261,421,69,36,63,101,138,682
95,Mehmet Okur,3,C,82,25,2304,354,756,0.468,17,63,0.27,337,693,0.486,0.479,329,387,0.85,194,422,616,166,32,68,141,227,1054
95,Mehmet Okur,4,PF,82,82,2945,519,1128,0.46,80,234,0.342,439,894,0.491,0.496,354,454,0.78,211,535,746,194,40,73,163,285,1472
96,Michael Wright,No NBA Data,,,,,,,,,,,,,,,,,,,,,,,,,,
97,Earl Watson,1,PG,64,0,964,96,212,0.453,16,44,0.364,80,168,0.476,0.491,23,36,0.639,31,52,83,125,60,5,51,93,231
97,Earl Watson,2,PG,79,2,1366,170,391,0.435,31,91,0.341,139,300,0.463,0.474,62,86,0.721,46,118,164,225,89,14,88,138,433
97,Earl Watson,3,PG,81,14,1669,172,464,0.371,26,106,0.245,146,358,0.408,0.399,90,138,0.652,49,129,178,402,91,19,146,175,460
97,Earl Watson,4,PG,80,14,1808,236,554,0.426,52,163,0.319,184,391,0.471,0.473,91,138,0.659,35,129,164,359,83,19,167,184,615
98,Jamison Brewer,1,SG,13,0,43,2,5,0.4,0,1,0,2,4,0.5,0.4,0,0,,2,6,8,9,2,0,3,3,4
98,Jamison Brewer,2,PG,10,0,80,9,17,0.529,0,2,0,9,15,0.6,0.529,4,9,0.444,5,4,9,18,2,1,6,11,22
98,Jamison Brewer,3,PG,13,1,160,13,35,0.371,5,14,0.357,8,21,0.381,0.443,1,6,0.167,2,9,11,17,7,0,10,9,32
98,Jamison Brewer,4,PG,18,0,185,11,37,0.297,3,15,0.2,8,22,0.364,0.338,6,13,0.462,6,16,22,12,8,1,13,11,31
99,Bobby Simmons,1,SF,30,3,343,43,95,0.453,4,14,0.286,39,81,0.481,0.474,22,30,0.733,25,27,52,17,13,5,14,31,112
99,Bobby Simmons,2,SG,36,2,378,44,112,0.393,0,5,0,44,107,0.411,0.393,32,35,0.914,33,44,77,20,10,3,8,51,120
99,Bobby Simmons,3,SF,56,8,1376,147,373,0.394,2,12,0.167,145,361,0.402,0.397,141,169,0.834,115,147,262,96,51,17,73,169,437
99,Bobby Simmons,4,SF,75,74,2799,474,1017,0.466,50,115,0.435,424,902,0.47,0.491,231,273,0.846,128,318,446,205,106,16,135,227,1229
100,Eric Chenowith,No NBA Data,,,,,,,,,,,,,,,,,,,,,,,,,,
101,Kyle Hill,No NBA Data,,,,,,,,,,,,,,,,,,,,,,,,,,
102,Sean Lampley,1,SF,35,0,487,56,129,0.434,0,4,0,56,125,0.448,0.434,57,82,0.695,26,57,83,31,7,3,25,43,169
102,Sean Lampley,2,SF,10,0,63,13,20,0.65,0,0,,13,20,0.65,0.65,8,12,0.667,2,9,11,2,0,1,3,2,34
103,Loren Woods,1,C,60,0,516,33,96,0.344,0,2,0,33,94,0.351,0.344,44,60,0.733,46,76,122,22,17,34,36,60,110
103,Loren Woods,2,C,38,11,353,29,76,0.382,1,3,0.333,28,73,0.384,0.388,21,27,0.778,27,68,95,19,10,13,23,37,80
103,Loren Woods,3,C,38,2,506,44,96,0.458,0,0,,44,96,0.458,0.458,33,55,0.6,65,69,134,10,11,19,26,52,121
103,Loren Woods,4,C,45,30,712,71,164,0.433,0,1,0,71,163,0.436,0.433,34,59,0.576,81,139,220,17,8,39,37,78,176
104,Ousmane Cisse,No NBA Data,,,,,,,,,,,,,,,,,,,,,,,,,,
105,Antonis Fotsis,1,PF,28,1,320,42,104,0.404,7,23,0.304,35,81,0.432,0.438,17,20,0.85,25,37,62,10,9,11,21,22,108
106,Ken Johnson,1,C,16,0,156,15,37,0.405,0,0,,15,37,0.405,0.405,2,6,0.333,4,28,32,0,1,12,6,20,32
107,Ruben Boumtje-Boumtje,1,C,33,1,245,13,32,0.406,0,0,,13,32,0.406,0.406,13,25,0.52,21,34,55,4,3,16,14,38,39
107,Ruben Boumtje-Boumtje,2,C,2,0,5,0,1,0,0,0,,0,1,0,0,0,0,,1,0,1,1,1,0,0,0,0
107,Ruben Boumtje-Boumtje,3,C,9,0,26,1,5,0.2,0,0,,1,5,0.2,0.2,2,2,1,0,1,1,1,0,1,0,2,4
108,Alton Ford,1,PF,53,0,452,61,118,0.517,0,0,,61,118,0.517,0.517,42,57,0.737,32,75,107,7,6,7,32,99,164
108,Alton Ford,2,PF,11,0,31,3,9,0.333,0,0,,3,9,0.333,0.333,1,3,0.333,0,6,6,1,0,0,2,7,7
108,Alton Ford,3,PF,9,0,41,6,11,0.545,0,0,,6,11,0.545,0.545,3,6,0.5,3,8,11,3,0,1,3,9,15
109,Andre Hutson,No NBA Data,,,,,,,,,,,,,,,,,,,,,,,,,,
110,Jarron Collins,1,C,70,68,1440,158,343,0.461,0,1,0,158,342,0.462,0.461,134,181,0.74,138,158,296,58,29,22,56,234,450
110,Jarron Collins,2,C,22,7,421,38,86,0.442,0,1,0,38,85,0.447,0.442,44,62,0.71,32,28,60,14,5,6,19,70,120
110,Jarron Collins,3,C,81,31,1732,147,295,0.498,0,1,0,147,294,0.5,0.498,188,262,0.718,117,199,316,77,26,18,79,255,482
110,Jarron Collins,4,C,50,38,961,65,157,0.414,0,1,0,65,156,0.417,0.414,83,119,0.697,57,107,164,61,11,6,34,146,213
111,Kenny Satterfield,1,PG,36,4,560,73,199,0.367,7,27,0.259,66,172,0.384,0.384,36,46,0.783,17,35,52,108,31,1,53,43,189
111,Kenny Satterfield,2,PG,39,6,502,55,183,0.301,5,28,0.179,50,155,0.323,0.314,17,25,0.68,16,27,43,68,20,2,43,36,132
111,Kenny Satterfield,3,PG,22,6,420,51,165,0.309,5,28,0.179,46,137,0.336,0.324,16,23,0.696,12,23,35,53,18,2,36,30,123
111,Kenny Satterfield,4,PG,17,0,82,4,18,0.222,0,0,,4,18,0.222,0.222,1,2,0.5,4,4,8,15,2,0,7,6,9
112,Maurice Jeffers,No NBA Data,,,,,,,,,,,,,,,,,,,,,,,,,,
113,Robertas Javtokas,No NBA Data,,,,,,,,,,,,,,,,,,,,,,,,,,
114,Alvin Jones,1,C,23,2,126,8,20,0.4,0,0,,8,20,0.4,0.4,10,20,0.5,13,23,36,3,3,9,11,35,26
115,Bryan Bracey,No NBA Data,,,,,,,,,,,,,,,,,,,,,,,,,,
116,Yao Ming,1,C,82,72,2382,401,805,0.498,1,2,0.5,400,803,0.498,0.499,301,371,0.811,196,479,675,137,31,147,173,230,1104
116,Yao Ming,2,C,82,82,2692,535,1025,0.522,0,2,0,535,1023,0.523,0.522,361,446,0.809,197,538,735,122,22,156,204,273,1431
116,Yao Ming,3,C,80,80,2447,538,975,0.552,0,0,,538,975,0.552,0.552,389,497,0.783,208,461,669,61,34,160,196,298,1465
116,Yao Ming,4,C,57,57,1949,467,900,0.519,0,1,0,467,899,0.519,0.519,337,395,0.853,148,433,581,85,30,94,147,195,1271
117,Jay Williams,1,PG,75,54,1961,273,685,0.399,65,202,0.322,208,483,0.431,0.446,103,161,0.64,27,168,195,350,86,17,171,179,714
118,Mike Dunleavy,1,SF,82,3,1305,168,417,0.403,52,150,0.347,116,267,0.434,0.465,78,100,0.78,66,148,214,106,53,19,86,120,466
118,Mike Dunleavy,2,SF,75,69,2336,323,720,0.449,94,254,0.37,229,466,0.491,0.514,137,185,0.741,87,355,442,220,68,13,143,169,877
118,Mike Dunleavy,3,SF,79,79,2570,408,905,0.451,107,276,0.388,301,629,0.479,0.51,134,172,0.779,97,338,435,203,79,26,132,198,1057
118,Mike Dunleavy,4,SF,81,68,2578,331,816,0.406,74,260,0.285,257,556,0.462,0.451,196,252,0.778,78,321,399,237,60,32,120,199,932
119,Drew Gooden,1,SF-PF,70,47,1873,355,777,0.457,14,48,0.292,341,729,0.468,0.466,151,212,0.712,163,292,455,83,53,35,150,172,875
119,Drew Gooden,2,SF,51,29,1329,255,576,0.443,14,46,0.304,241,530,0.455,0.455,92,132,0.697,105,190,295,63,38,22,105,121,616
119,Drew Gooden,3,PF,19,18,544,100,201,0.498,0,2,0,100,199,0.503,0.498,59,80,0.738,58,102,160,20,15,13,45,51,259
119,Drew Gooden,4,PF,79,17,2134,369,829,0.445,9,42,0.214,360,787,0.457,0.451,167,262,0.637,160,356,516,89,62,72,126,196,914
120,Nikoloz Tskitishvili,1,SF,81,16,1320,115,393,0.293,37,152,0.243,78,241,0.324,0.34,48,65,0.738,64,117,181,91,31,29,84,136,315
120,Nikoloz Tskitishvili,2,PF,39,0,307,40,122,0.328,3,11,0.273,37,111,0.333,0.34,23,29,0.793,24,39,63,10,6,8,17,50,106
120,Nikoloz Tskitishvili,3,PF,35,0,220,22,74,0.297,2,17,0.118,20,57,0.351,0.311,4,7,0.571,12,29,41,10,8,11,19,33,50
120,Nikoloz Tskitishvili,4,PF,23,0,158,15,51,0.294,0,7,0,15,44,0.341,0.294,4,7,0.571,11,18,29,4,8,8,14,24,34
121,Dajuan Wagner,1,SG,47,24,1385,223,605,0.369,55,174,0.316,168,431,0.39,0.414,128,160,0.8,20,62,82,130,38,7,85,107,629
121,Dajuan Wagner,2,SG,44,4,708,112,306,0.366,31,86,0.36,81,220,0.368,0.417,32,47,0.681,9,49,58,51,26,7,41,89,287
121,Dajuan Wagner,3,SG,11,0,102,18,55,0.327,5,26,0.192,13,29,0.448,0.373,3,4,0.75,0,2,2,13,5,0,9,15,44
121,Dajuan Wagner,4,SG,1,0,7,1,1,1,1,1,1,0,0,,1.5,1,2,0.5,0,0,0,1,0,0,1,1,4
122,Nene Hilario,1,C,80,53,2258,321,619,0.519,0,3,0,321,616,0.521,0.519,197,341,0.578,208,283,491,149,127,65,181,295,839
122,Nene Hilario,2,PF,77,77,2504,334,630,0.53,0,2,0,334,628,0.532,0.53,240,352,0.682,154,349,503,168,116,41,183,280,908
122,Nene Hilario,3,C,55,18,1317,194,386,0.503,0,2,0,194,384,0.505,0.503,140,212,0.66,104,221,325,84,50,48,94,167,528
122,Nene Hilario,4,PF,1,0,3,0,1,0,0,0,,0,1,0,0,0,0,,0,0,0,0,0,0,2,1,0
123,Chris Wilcox,1,PF,46,3,479,73,140,0.521,0,0,,73,140,0.521,0.521,25,50,0.5,32,72,104,21,7,12,26,65,171
123,Chris Wilcox,2,C,65,17,1340,227,436,0.521,0,1,0,227,435,0.522,0.521,105,150,0.7,125,180,305,51,29,20,80,183,559
123,Chris Wilcox,3,C,54,25,1005,169,329,0.514,0,0,,169,329,0.514,0.514,88,144,0.611,63,165,228,38,26,24,77,129,426
123,Chris Wilcox,4,C-PF,77,24,1529,257,450,0.571,0,2,0,257,448,0.574,0.571,112,153,0.732,118,292,410,52,33,34,72,183,626
124,Amar'e Stoudemire,1,PF,82,71,2570,392,830,0.472,2,10,0.2,390,820,0.476,0.473,320,484,0.661,250,471,721,78,62,87,189,269,1106
124,Amar'e Stoudemire,2,PF,55,53,2025,411,865,0.475,1,5,0.2,410,860,0.477,0.476,310,435,0.713,157,339,496,78,64,89,177,188,1133
124,Amar'e Stoudemire,3,C,80,80,2889,747,1336,0.559,3,16,0.188,744,1320,0.564,0.56,583,795,0.733,219,494,713,131,77,130,189,278,2080
124,Amar'e Stoudemire,4,C,3,3,50,9,27,0.333,0,1,0,9,26,0.346,0.333,8,9,0.889,6,10,16,2,1,3,1,4,26
125,Caron Butler,1,SF,78,78,2858,429,1032,0.416,34,107,0.318,395,925,0.427,0.432,309,375,0.824,135,262,397,213,137,31,192,230,1201
125,Caron Butler,2,SF,68,56,2030,240,631,0.38,10,42,0.238,230,589,0.39,0.388,133,176,0.756,92,234,326,126,75,13,91,162,623
125,Caron Butler,3,SF,77,77,2746,441,991,0.445,38,125,0.304,403,866,0.465,0.464,275,319,0.862,146,304,450,146,110,23,125,213,1195
125,Caron Butler,4,SF,75,54,2708,494,1086,0.455,41,120,0.342,453,966,0.469,0.474,289,332,0.87,114,352,466,186,127,18,175,238,1318
126,Jared Jeffries,1,SF,20,1,292,30,63,0.476,3,6,0.5,27,57,0.474,0.5,16,29,0.552,26,32,58,16,8,5,21,28,79
126,Jared Jeffries,2,PF,82,38,1913,177,469,0.377,5,30,0.167,172,439,0.392,0.383,105,171,0.614,180,244,424,93,48,28,107,212,464
126,Jared Jeffries,3,SF,77,71,2007,203,434,0.468,16,51,0.314,187,383,0.488,0.486,101,173,0.584,152,222,374,151,66,35,114,206,523
126,Jared Jeffries,4,PF,77,77,1951,187,415,0.451,16,50,0.32,171,365,0.468,0.47,99,168,0.589,164,215,379,148,58,50,99,223,489
127,Melvin Ely,1,C,52,7,802,92,186,0.495,0,0,,92,186,0.495,0.495,52,74,0.703,64,110,174,15,10,32,50,95,236
127,Melvin Ely,2,PF,42,2,510,66,153,0.431,0,1,0,66,152,0.434,0.431,25,42,0.595,48,53,101,22,9,17,20,68,157
127,Melvin Ely,3,PF,79,17,1649,227,526,0.432,0,0,,227,526,0.432,0.432,122,212,0.575,142,184,326,76,32,69,115,199,576
127,Melvin Ely,4,PF,57,22,1348,216,425,0.508,0,2,0,216,423,0.511,0.508,128,192,0.667,94,183,277,76,29,44,100,160,560
128,Marcus Haislip,1,PF,39,8,441,66,153,0.431,3,12,0.25,63,141,0.447,0.441,26,38,0.684,21,32,53,9,7,18,21,55,161
128,Marcus Haislip,2,PF,31,0,263,36,74,0.486,1,2,0.5,35,72,0.486,0.493,20,28,0.714,21,32,53,4,6,12,9,25,93
128,Marcus Haislip,3,PF,9,0,106,13,38,0.342,0,1,0,13,37,0.351,0.342,6,11,0.545,5,10,15,3,2,2,6,15,32
128,Marcus Haislip,4,SF,10,0,44,10,21,0.476,3,5,0.6,7,16,0.438,0.548,2,5,0.4,4,6,10,0,0,2,3,5,25
129,Fred Jones,1,SG,19,1,115,9,24,0.375,2,7,0.286,7,17,0.412,0.417,3,4,0.75,4,5,9,5,6,1,6,13,23
129,Fred Jones,2,SG,81,2,1508,123,311,0.395,27,89,0.303,96,222,0.432,0.439,124,149,0.832,25,101,126,173,65,18,73,132,397
129,Fred Jones,3,SG,77,14,2268,275,647,0.425,87,229,0.38,188,418,0.45,0.492,176,207,0.85,34,208,242,196,61,31,114,171,813
129,Fred Jones,4,SG,68,2,1837,233,559,0.417,63,187,0.337,170,372,0.457,0.473,122,160,0.763,18,152,170,154,55,20,107,142,651
130,Bostjan Nachbar,1,SF,14,1,77,11,31,0.355,2,10,0.2,9,21,0.429,0.387,5,10,0.5,3,8,11,3,2,2,6,13,29
130,Bostjan Nachbar,2,SF,45,3,516,47,132,0.356,23,63,0.365,24,69,0.348,0.443,21,29,0.724,8,62,70,30,14,14,23,72,138
130,Bostjan Nachbar,3,PF-SF,71,6,1341,161,411,0.392,75,196,0.383,86,215,0.4,0.483,97,117,0.829,24,158,182,74,29,16,73,183,494
130,Bostjan Nachbar,4,SF,16,2,204,15,43,0.349,10,21,0.476,5,22,0.227,0.465,9,12,0.75,4,26,30,9,1,0,5,30,49
131,Jiri Welsch,1,SF,37,0,234,19,75,0.253,1,4,0.25,18,71,0.254,0.26,22,29,0.759,12,16,28,27,8,2,19,32,61
131,Jiri Welsch,2,SG,81,68,2179,262,612,0.428,69,181,0.381,193,431,0.448,0.484,153,206,0.743,60,236,296,183,101,7,129,176,746
131,Jiri Welsch,3,SG-SF,71,32,1317,149,371,0.402,34,110,0.309,115,261,0.441,0.447,129,169,0.763,26,141,167,103,44,5,73,121,461
131,Jiri Welsch,4,SG,55,32,1125,137,320,0.428,32,99,0.323,105,221,0.475,0.478,109,141,0.773,20,119,139,84,39,5,58,105,415
132,Juan Dixon,1,PG,42,3,647,104,271,0.384,25,84,0.298,79,187,0.422,0.43,37,46,0.804,13,59,72,40,26,3,42,54,270
132,Juan Dixon,2,SG,71,16,1478,247,637,0.388,59,198,0.298,188,439,0.428,0.434,111,139,0.799,30,118,148,137,82,4,104,111,664
132,Juan Dixon,3,SG,63,4,1054,186,447,0.416,48,147,0.327,138,300,0.46,0.47,87,97,0.897,32,87,119,111,43,4,68,98,507
132,Juan Dixon,4,SG,76,42,1920,357,821,0.435,65,170,0.382,292,651,0.449,0.474,156,194,0.804,30,147,177,149,58,6,113,157,935
133,Curtis Borchardt,1,C,16,0,258,22,56,0.393,0,1,0,22,55,0.4,0.393,14,18,0.778,13,41,54,15,4,14,18,40,58
133,Curtis Borchardt,2,C,67,23,859,74,172,0.43,0,0,,74,172,0.43,0.43,52,71,0.732,86,138,224,49,10,32,52,160,200
134,Ryan Humphrey,1,PF,48,1,444,35,120,0.292,0,0,,35,120,0.292,0.292,23,39,0.59,34,65,99,11,9,18,23,75,93
134,Ryan Humphrey,2,PF,35,1,322,23,85,0.271,0,0,,23,85,0.271,0.271,18,28,0.643,30,39,69,7,4,16,21,57,64
134,Ryan Humphrey,3,PF,13,0,122,12,35,0.343,0,0,,12,35,0.343,0.343,5,11,0.455,4,26,30,4,5,2,2,18,29
134,Ryan Humphrey,4,PF,2,0,11,1,4,0.25,0,1,0,1,3,0.333,0.25,0,0,,2,1,3,1,1,0,2,3,2
135,Kareem Rush,1,PG,76,0,872,96,244,0.393,19,68,0.279,77,176,0.438,0.432,16,23,0.696,26,68,94,68,10,11,63,71,227
135,Kareem Rush,2,SG,72,15,1244,190,432,0.44,48,138,0.348,142,294,0.483,0.495,31,52,0.596,20,77,97,59,33,20,48,109,459
135,Kareem Rush,3,SG,48,22,968,157,406,0.387,51,137,0.372,106,269,0.394,0.45,37,48,0.771,20,69,89,68,20,7,47,74,402
135,Kareem Rush,4,SG,14,0,91,4,20,0.2,2,10,0.2,2,10,0.2,0.25,2,2,1,3,7,10,3,2,1,3,7,12
136,Qyntel Woods,1,PF,53,0,334,59,118,0.5,3,9,0.333,56,109,0.514,0.513,7,20,0.35,15,38,53,12,15,1,23,36,128
136,Qyntel Woods,2,SF,62,8,673,88,237,0.371,10,29,0.345,78,208,0.375,0.392,38,60,0.633,46,90,136,46,20,14,52,88,224
136,Qyntel Woods,3,SF,3,0,40,5,12,0.417,0,0,,5,12,0.417,0.417,0,0,,2,4,6,0,4,0,2,6,10
136,Qyntel Woods,4,SF,49,16,1013,129,254,0.508,22,60,0.367,107,194,0.552,0.551,49,76,0.645,44,146,190,47,32,13,61,96,329
137,Casey Jacobsen,1,SF,72,0,1147,122,327,0.373,52,165,0.315,70,162,0.432,0.453,72,105,0.686,29,54,83,73,35,6,55,90,368
137,Casey Jacobsen,2,SF,78,13,1828,150,360,0.417,75,180,0.417,75,180,0.417,0.521,91,111,0.82,42,159,201,98,48,9,68,144,466
137,Casey Jacobsen,3,SG-SF,84,1,1798,165,408,0.404,66,177,0.373,99,231,0.429,0.485,151,192,0.786,35,132,167,113,33,8,71,104,547
137,Casey Jacobsen,4,SF,40,0,768,65,157,0.414,34,89,0.382,31,68,0.456,0.522,48,62,0.774,17,50,67,37,11,1,27,56,212
138,Tayshaun Prince,1,SF,42,5,435,53,118,0.449,20,47,0.426,33,71,0.465,0.534,11,17,0.647,5,40,45,24,10,14,21,25,137
138,Tayshaun Prince,2,SF,82,80,2701,338,723,0.467,57,157,0.363,281,566,0.496,0.507,108,141,0.766,93,297,390,191,63,69,119,149,841
138,Tayshaun Prince,3,SF,82,82,3039,469,963,0.487,47,138,0.341,422,825,0.512,0.511,221,274,0.807,133,302,435,247,56,71,135,161,1206
138,Tayshaun Prince,4,SF,82,82,2898,455,999,0.455,64,183,0.35,391,816,0.479,0.487,182,238,0.765,104,242,346,186,62,39,91,96,1156
139,Nenad Krstic,1,PF,75,57,1965,281,570,0.493,0,2,0,281,568,0.495,0.493,185,255,0.725,161,240,401,77,32,63,112,280,747
139,Nenad Krstic,2,PF,80,80,2469,447,881,0.507,1,4,0.25,446,877,0.509,0.508,185,265,0.698,182,331,513,88,32,63,133,297,1080
139,Nenad Krstic,3,C,26,26,848,170,323,0.526,0,1,0,170,322,0.528,0.526,86,121,0.711,51,125,176,46,10,24,52,88,426
139,Nenad Krstic,4,C,45,38,812,123,300,0.41,0,2,0,123,298,0.413,0.41,52,69,0.754,35,165,200,27,9,17,41,111,298
140,Frank Williams,1,PG,21,0,167,9,33,0.273,6,16,0.375,3,17,0.176,0.364,4,6,0.667,3,15,18,34,7,2,17,20,28
140,Frank Williams,2,PG,56,3,714,80,208,0.385,18,60,0.3,62,148,0.419,0.428,41,48,0.854,8,45,53,121,25,6,63,58,219
140,Frank Williams,3,SG,9,0,71,3,20,0.15,0,4,0,3,16,0.188,0.15,0,0,,2,4,6,11,2,3,3,9,6
141,John Salmons,1,PG,64,1,504,48,116,0.414,10,31,0.323,38,85,0.447,0.457,26,35,0.743,16,43,59,47,17,6,29,53,132
141,John Salmons,2,SG,77,24,1603,161,416,0.387,50,147,0.34,111,269,0.413,0.447,71,92,0.772,38,158,196,134,62,16,77,122,443
141,John Salmons,3,SG,58,8,993,85,210,0.405,31,91,0.341,54,119,0.454,0.479,35,48,0.729,12,109,121,114,40,13,51,92,236
141,John Salmons,4,SG,82,24,2059,219,521,0.42,26,87,0.299,193,434,0.445,0.445,155,200,0.775,48,172,220,223,73,13,125,178,619
142,Chris Jefferies,1,SF,51,10,666,75,194,0.387,18,54,0.333,57,140,0.407,0.433,29,43,0.674,16,43,59,22,19,16,45,56,197
142,Chris Jefferies,2,SF-SG,21,2,195,27,72,0.375,17,42,0.405,10,30,0.333,0.493,13,20,0.65,5,24,29,7,4,7,19,36,84
142,Chris Jefferies,3,SG,2,0,8,3,6,0.5,1,3,0.333,2,3,0.667,0.583,1,1,1,0,1,1,1,0,0,1,0,8
142,Chris Jefferies,4,SF,19,2,187,24,66,0.364,16,39,0.41,8,27,0.296,0.485,12,19,0.632,5,23,28,6,4,7,18,36,76
143,Dan Dickau,1,PG,50,0,515,70,170,0.412,22,61,0.361,48,109,0.44,0.476,21,26,0.808,9,34,43,85,14,2,53,66,183
143,Dan Dickau,2,PG,43,0,294,37,98,0.378,10,30,0.333,27,68,0.397,0.429,11,14,0.786,7,19,26,38,17,0,26,44,95
143,Dan Dickau,3,PG,23,0,143,21,49,0.429,3,10,0.3,18,39,0.462,0.459,4,6,0.667,4,12,16,18,9,0,13,22,49
143,Dan Dickau,4,PG,20,0,151,16,49,0.327,7,20,0.35,9,29,0.31,0.398,7,8,0.875,3,7,10,20,8,0,13,22,46
144,Steve Logan,No NBA Data,,,,,,,,,,,,,,,,,,,,,,,,,,
145,Roger Mason,1,SF,17,0,113,11,31,0.355,6,18,0.333,5,13,0.385,0.452,2,2,1,2,10,12,12,4,0,5,20,30
145,Roger Mason,2,SG,26,3,328,32,98,0.327,13,39,0.333,19,59,0.322,0.393,19,22,0.864,1,30,31,26,11,6,20,36,96
145,Roger Mason,3,SG,3,0,43,1,11,0.091,1,6,0.167,0,5,0,0.136,0,0,,0,3,3,3,1,0,2,5,3
145,Roger Mason,4,SG,23,3,285,31,87,0.356,12,33,0.364,19,54,0.352,0.425,19,22,0.864,1,27,28,23,10,6,18,31,93
146,Robert Archibald,1,PF,12,0,72,6,20,0.3,0,0,,6,20,0.3,0.3,7,18,0.389,6,11,17,3,0,3,7,9,19
146,Robert Archibald,2,C-PF,32,3,256,9,33,0.273,0,0,,9,33,0.273,0.273,14,31,0.452,21,31,52,13,14,3,10,50,32
146,Robert Archibald,3,PF,1,0,6,0,1,0,0,0,,0,1,0,0,1,2,0.5,0,1,1,1,0,0,1,1,1
146,Robert Archibald,4,PF,1,0,4,1,2,0.5,0,0,,1,2,0.5,0.5,0,2,0,0,1,1,0,1,0,0,0,2
147,Vincent Yarbrough,1,SG,59,39,1381,168,428,0.393,21,78,0.269,147,350,0.42,0.417,49,62,0.79,36,126,162,130,57,33,81,145,406
148,Dan Gadzuric,1,C,49,30,760,70,145,0.483,0,1,0,70,144,0.486,0.483,29,56,0.518,66,131,197,9,22,52,27,125,169
148,Dan Gadzuric,2,C,75,0,1260,183,349,0.524,0,1,0,183,348,0.526,0.524,58,118,0.492,126,220,346,28,51,105,45,186,424
148,Dan Gadzuric,3,C,81,81,1783,243,451,0.539,0,0,,243,451,0.539,0.539,107,199,0.538,261,413,674,30,47,106,81,224,593
148,Dan Gadzuric,4,C,74,0,885,171,309,0.553,0,1,0,171,308,0.555,0.553,41,89,0.461,91,141,232,24,25,43,35,171,383
149,Carlos Boozer,1,PF,81,54,2049,331,618,0.536,0,1,0,331,617,0.536,0.536,148,192,0.771,202,407,609,106,59,50,103,224,810
149,Carlos Boozer,2,PF,75,75,2592,471,900,0.523,1,6,0.167,470,894,0.526,0.524,219,285,0.768,230,627,857,148,74,55,134,199,1162
149,Carlos Boozer,3,PF,51,51,1772,361,693,0.521,0,1,0,361,692,0.522,0.521,187,268,0.698,141,316,457,144,41,24,137,179,909
149,Carlos Boozer,4,PF,33,19,1025,219,399,0.549,0,0,,219,399,0.549,0.549,99,137,0.723,73,212,285,88,30,8,69,105,537
150,Milos Vujanic,No NBA Data,,,,,,,,,,,,,,,,,,,,,,,,,,
151,David Andersen,1,C,63,0,891,147,340,0.432,27,78,0.346,120,262,0.458,0.472,46,67,0.687,54,154,208,44,15,12,37,119,367
151,David Andersen,2,PF,40,0,373,56,121,0.463,8,23,0.348,48,98,0.49,0.496,14,22,0.636,20,64,84,13,5,9,22,40,134
151,David Andersen,3,PF,11,0,150,23,47,0.489,3,10,0.3,20,37,0.541,0.521,7,7,1,8,26,34,7,3,3,8,11,56
151,David Andersen,4,PF,29,0,223,33,74,0.446,5,13,0.385,28,61,0.459,0.48,7,15,0.467,12,38,50,6,2,6,14,29,78
152,Tito Maddox,1,SG,9,0,35,3,12,0.25,0,3,0,3,9,0.333,0.25,5,8,0.625,1,6,7,5,3,1,3,4,11
153,Rod Grizzard,No NBA Data,,,,,,,,,,,,,,,,,,,,,,,,,,
154,Juan Carlos Navarro,1,SG,82,30,2117,308,766,0.402,156,432,0.361,152,334,0.455,0.504,124,146,0.849,34,176,210,177,48,1,134,94,896
155,Mario Kasun,1,C,45,0,356,47,98,0.48,0,1,0,47,97,0.485,0.48,24,43,0.558,52,76,128,8,8,13,26,86,118
155,Mario Kasun,2,C,28,0,213,31,69,0.449,0,0,,31,69,0.449,0.449,18,23,0.783,24,36,60,3,2,3,15,69,80
156,Ronald Murray,1,SG,14,0,62,11,31,0.355,0,5,0,11,26,0.423,0.355,5,8,0.625,0,4,4,5,4,0,8,0,27
156,Ronald Murray,2,SG,12,0,42,9,26,0.346,0,4,0,9,22,0.409,0.346,5,8,0.625,0,1,1,3,4,0,4,0,23
156,Ronald Murray,3,SG,2,0,20,2,5,0.4,0,1,0,2,4,0.5,0.4,0,0,,0,3,3,2,0,0,4,0,4
156,Ronald Murray,4,PG,82,18,2021,389,915,0.425,67,229,0.293,322,686,0.469,0.462,168,235,0.715,45,159,204,205,81,28,149,158,1013
157,Jason Jennings,No NBA Data,,,,,,,,,,,,,,,,,,,,,,,,,,
158,Lonny Baxter,1,C,55,0,682,96,206,0.466,0,2,0,96,204,0.471,0.466,70,103,0.68,65,100,165,16,9,22,46,135,262
158,Lonny Baxter,2,C-PF,62,5,766,103,209,0.493,1,3,0.333,102,206,0.495,0.495,44,76,0.579,64,123,187,20,17,29,38,123,251
158,Lonny Baxter,3,PF,14,1,147,27,49,0.551,1,1,1,26,48,0.542,0.561,5,8,0.625,11,24,35,5,1,6,11,31,60
158,Lonny Baxter,4,C,36,4,487,60,128,0.469,0,1,0,60,127,0.472,0.469,30,56,0.536,42,79,121,10,14,18,22,69,150
159,Sam Clancy,No NBA Data,,,,,,,,,,,,,,,,,,,,,,,,,,
160,Matt Barnes,1,SF,38,9,724,63,138,0.457,2,13,0.154,61,125,0.488,0.464,43,61,0.705,53,98,151,48,27,3,44,76,171
160,Matt Barnes,2,SF,43,9,715,62,151,0.411,5,22,0.227,57,129,0.442,0.427,35,58,0.603,49,84,133,57,30,7,45,80,164
160,Matt Barnes,3,PF-SF,56,5,631,70,140,0.5,3,15,0.2,67,125,0.536,0.511,32,47,0.681,48,73,121,28,20,7,30,100,175
160,Matt Barnes,4,SF,6,5,93,11,30,0.367,1,4,0.25,10,26,0.385,0.383,3,4,0.75,7,17,24,6,4,0,6,8,26
161,Jamal Sampson,1,PF,5,0,8,0,2,0,0,0,,0,2,0,0,0,0,,1,1,2,1,1,0,0,0,0
161,Jamal Sampson,2,C,10,2,130,11,23,0.478,0,0,,11,23,0.478,0.478,7,12,0.583,23,29,52,7,2,4,6,16,29
161,Jamal Sampson,3,PF,23,0,329,28,62,0.452,0,0,,28,62,0.452,0.452,23,39,0.59,36,86,122,8,4,17,17,53,79
161,Jamal Sampson,4,PF,12,0,39,5,7,0.714,0,0,,5,7,0.714,0.714,0,2,0,5,13,18,5,0,4,0,5,10
162,Chris Owens,1,SF,1,0,6,2,3,0.667,0,0,,2,3,0.667,0.667,0,0,,1,0,1,0,0,0,1,0,4
163,Peter Fehse,No NBA Data,,,,,,,,,,,,,,,,,,,,,,,,,,
164,Darius Songaila,1,PF,73,7,976,133,273,0.487,0,0,,133,273,0.487,0.487,71,88,0.807,91,134,225,48,42,12,43,126,337
164,Darius Songaila,2,PF,81,21,1668,257,488,0.527,0,3,0,257,485,0.53,0.527,94,111,0.847,125,219,344,114,51,18,70,206,608
164,Darius Songaila,3,PF,62,7,1329,236,491,0.481,2,5,0.4,234,486,0.481,0.483,94,115,0.817,76,170,246,88,35,16,85,157,568
164,Darius Songaila,4,PF,37,1,700,118,225,0.524,0,2,0,118,223,0.529,0.524,46,54,0.852,44,90,134,38,17,10,43,105,282
165,Federico Kammerichs,No NBA Data,,,,,,,,,,,,,,,,,,,,,,,,,,
166,Marcus Taylor,No NBA Data,,,,,,,,,,,,,,,,,,,,,,,,,,
167,Rasual Butler,1,SG,72,28,1514,207,572,0.362,50,171,0.292,157,401,0.392,0.406,76,104,0.731,29,157,186,93,21,43,77,105,540
167,Rasual Butler,2,SF,45,0,675,119,250,0.476,50,108,0.463,69,142,0.486,0.576,16,21,0.762,4,57,61,23,10,13,28,72,304
167,Rasual Butler,3,SF,65,15,1203,163,409,0.399,57,153,0.373,106,256,0.414,0.468,37,48,0.771,15,136,151,62,18,29,37,104,420
167,Rasual Butler,4,SF,79,20,1875,257,633,0.406,92,242,0.38,165,391,0.422,0.479,79,114,0.693,51,181,232,40,33,45,65,142,685
168,Tamar Slay,1,SG,36,0,274,39,103,0.379,7,25,0.28,32,78,0.41,0.413,7,10,0.7,8,23,31,14,14,3,20,31,92
168,Tamar Slay,2,SG,22,0,165,21,60,0.35,4,12,0.333,17,48,0.354,0.383,7,14,0.5,10,15,25,14,7,1,11,20,53
168,Tamar Slay,3,SG,8,0,78,13,39,0.333,2,12,0.167,11,27,0.407,0.359,0,2,0,6,8,14,3,5,0,8,20,28
169,Mladen Sekularac,No NBA Data,,,,,,,,,,,,,,,,,,,,,,,,,,
170,Luis Scola,1,PF,82,39,2024,345,670,0.515,0,3,0,345,667,0.517,0.515,157,235,0.668,174,351,525,106,60,19,105,235,847
170,Luis Scola,2,PF,82,82,2488,424,799,0.531,0,3,0,424,796,0.533,0.531,196,258,0.76,200,520,720,123,68,11,123,261,1044
170,Luis Scola,3,PF,82,82,2671,560,1090,0.514,1,5,0.2,559,1085,0.515,0.514,208,267,0.779,175,530,705,169,63,26,163,246,1329
170,Luis Scola,4,PF,74,74,2412,569,1129,0.504,0,3,0,569,1126,0.505,0.504,214,290,0.738,147,459,606,185,48,44,147,227,1352
171,Randy Holcomb,1,SF,4,0,11,1,1,1,0,0,,1,1,1,1,0,0,,1,0,1,0,0,0,0,2,2
172,Corsley Edwards,1,C,10,0,110,10,31,0.323,0,0,,10,31,0.323,0.323,7,12,0.583,12,13,25,3,3,4,2,19,27
173,LeBron James,1,SG,79,79,3122,622,1492,0.417,63,217,0.29,559,1275,0.438,0.438,347,460,0.754,99,333,432,465,130,58,273,149,1654
173,LeBron James,2,SF,80,80,3388,795,1684,0.472,108,308,0.351,687,1376,0.499,0.504,477,636,0.75,111,477,588,577,177,52,262,146,2175
173,LeBron James,3,SF,79,79,3361,875,1823,0.48,127,379,0.335,748,1444,0.518,0.515,601,814,0.738,75,481,556,521,123,66,260,181,2478
173,LeBron James,4,SF,78,78,3190,772,1621,0.476,99,310,0.319,673,1311,0.513,0.507,489,701,0.698,83,443,526,470,125,55,250,171,2132
174,Darko Milicic,1,C,34,0,159,17,65,0.262,0,1,0,17,64,0.266,0.262,14,24,0.583,11,32,43,7,7,15,13,33,48
174,Darko Milicic,2,C,37,2,254,25,76,0.329,0,0,,25,76,0.329,0.329,17,24,0.708,3,40,43,7,2,17,16,31,67
174,Darko Milicic,3,C,55,1,767,119,234,0.509,0,2,0,119,232,0.513,0.509,28,50,0.56,44,107,151,41,14,77,51,92,266
174,Darko Milicic,4,C,25,0,140,17,33,0.515,0,2,0,17,31,0.548,0.515,3,8,0.375,10,18,28,9,3,15,15,25,37
175,Carmelo Anthony,1,SF,82,82,2995,624,1465,0.426,69,214,0.322,555,1251,0.444,0.449,408,525,0.777,183,315,498,227,97,41,247,225,1725
175,Carmelo Anthony,2,SF,75,75,2608,530,1230,0.431,42,158,0.266,488,1072,0.455,0.448,456,573,0.796,141,285,426,194,68,30,224,229,1558
175,Carmelo Anthony,3,SF,80,80,2941,756,1572,0.481,37,152,0.243,719,1420,0.506,0.493,573,709,0.808,122,272,394,216,88,42,218,229,2122
175,Carmelo Anthony,4,SF,65,65,2486,691,1453,0.476,40,149,0.268,651,1304,0.499,0.489,459,568,0.808,143,248,391,249,77,23,234,203,1881
176,Chris Bosh,1,C,75,63,2510,327,712,0.459,5,14,0.357,322,698,0.461,0.463,202,288,0.701,191,366,557,78,59,106,107,215,861
176,Chris Bosh,2,PF,81,81,3017,473,1005,0.471,3,10,0.3,470,995,0.472,0.472,412,542,0.76,194,524,718,153,76,113,187,226,1361
176,Chris Bosh,3,C,70,70,2751,549,1087,0.505,0,13,0,549,1074,0.511,0.505,474,581,0.816,204,443,647,181,50,79,157,209,1572
176,Chris Bosh,4,C,69,69,2658,543,1094,0.496,12,35,0.343,531,1059,0.501,0.502,463,590,0.785,186,555,741,175,39,90,179,163,1561
177,Dwyane Wade,1,PG,61,56,2126,371,798,0.465,16,53,0.302,355,745,0.477,0.475,233,312,0.747,85,162,247,275,86,34,196,140,991
177,Dwyane Wade,2,SG,77,77,2974,630,1318,0.478,13,45,0.289,617,1273,0.485,0.483,581,762,0.762,110,287,397,520,121,82,321,230,1854
177,Dwyane Wade,3,SG,75,75,2892,699,1413,0.495,13,76,0.171,686,1337,0.513,0.499,629,803,0.783,107,323,430,503,146,58,268,217,2040
177,Dwyane Wade,4,SG,51,50,1931,472,962,0.491,21,79,0.266,451,883,0.511,0.502,432,535,0.807,51,188,239,384,107,62,216,117,1397
178,Chris Kaman,1,C,82,61,1843,200,435,0.46,0,2,0,200,433,0.462,0.46,99,142,0.697,126,335,461,85,23,73,155,211,499
178,Chris Kaman,2,C,63,50,1632,246,495,0.497,0,1,0,246,494,0.498,0.497,80,121,0.661,135,288,423,73,26,68,115,182,572
178,Chris Kaman,3,C,78,78,2560,369,706,0.523,0,2,0,369,704,0.524,0.523,194,252,0.77,187,563,750,79,45,108,176,269,932
178,Chris Kaman,4,C,75,66,2176,294,652,0.451,0,1,0,294,651,0.452,0.451,166,224,0.741,160,428,588,79,41,116,147,251,754
179,Kirk Hinrich,1,PG,76,66,2706,318,823,0.386,144,369,0.39,174,454,0.383,0.474,135,168,0.804,42,217,259,517,101,21,204,276,915
179,Kirk Hinrich,2,PG,77,77,2800,445,1122,0.397,145,408,0.355,300,714,0.42,0.461,171,216,0.792,32,272,304,494,122,21,176,244,1206
179,Kirk Hinrich,3,PG,81,81,2955,451,1078,0.418,126,341,0.37,325,737,0.441,0.477,256,314,0.815,29,259,288,514,94,21,188,251,1284
179,Kirk Hinrich,4,PG,80,80,2839,475,1061,0.448,140,337,0.415,335,724,0.463,0.514,237,284,0.835,32,242,274,500,100,23,191,274,1327
180,T.J. Ford,1,PG,55,55,1472,153,398,0.384,5,21,0.238,148,377,0.393,0.391,80,98,0.816,37,140,177,356,60,3,139,123,391
180,T.J. Ford,2,PG,72,70,2557,328,789,0.416,35,104,0.337,293,685,0.428,0.438,187,248,0.754,63,248,311,473,104,7,219,196,878
180,T.J. Ford,3,PG,75,71,2243,393,902,0.436,21,69,0.304,372,833,0.447,0.447,240,293,0.819,53,183,236,595,101,8,231,186,1047
180,T.J. Ford,4,PG,51,26,1199,246,524,0.469,15,51,0.294,231,473,0.488,0.484,110,125,0.88,23,77,100,313,54,0,102,93,617
181,Mike Sweetney,1,PF,42,1,494,69,140,0.493,0,1,0,69,139,0.496,0.493,42,58,0.724,68,89,157,14,18,12,32,57,180
181,Mike Sweetney,2,C,77,28,1509,237,446,0.531,0,1,0,237,445,0.533,0.531,176,235,0.749,169,249,418,44,27,28,108,224,650
181,Mike Sweetney,3,C,66,44,1222,200,444,0.45,0,0,,200,444,0.45,0.45,133,204,0.652,118,232,350,59,19,56,95,209,533
181,Mike Sweetney,4,C,48,0,385,58,134,0.433,0,0,,58,134,0.433,0.433,37,66,0.561,45,75,120,28,9,11,42,79,153
182,Jarvis Hayes,1,SF,70,42,2044,278,695,0.4,40,131,0.305,238,564,0.422,0.429,77,98,0.786,71,193,264,106,71,11,110,157,673
182,Jarvis Hayes,2,SF,54,22,1560,206,530,0.389,42,123,0.341,164,407,0.403,0.428,99,118,0.839,41,186,227,90,49,9,62,107,553
182,Jarvis Hayes,3,SG,21,13,516,77,183,0.421,17,47,0.362,60,136,0.441,0.467,25,30,0.833,19,57,76,27,16,1,22,38,196
182,Jarvis Hayes,4,SF,81,17,1626,224,546,0.41,66,183,0.361,158,363,0.435,0.471,71,84,0.845,42,168,210,80,48,13,56,160,585
183,Mickael Pietrus,1,PG,53,22,748,96,231,0.416,35,105,0.333,61,126,0.484,0.491,52,75,0.693,48,71,119,27,32,12,40,100,279
183,Mickael Pietrus,2,SF,67,3,1340,214,501,0.427,67,195,0.344,147,306,0.48,0.494,141,202,0.698,65,124,189,82,46,18,92,139,636
183,Mickael Pietrus,3,SF,52,18,1179,169,418,0.404,56,176,0.318,113,242,0.467,0.471,87,143,0.608,58,105,163,44,33,10,78,132,481
183,Mickael Pietrus,4,SF,72,38,1937,286,586,0.488,93,240,0.388,193,346,0.558,0.567,136,210,0.648,81,246,327,62,48,55,105,220,801
184,Nick Collison,1,C,82,4,1396,190,354,0.537,0,3,0,190,351,0.541,0.537,83,118,0.703,156,220,376,32,34,50,62,252,463
184,Nick Collison,2,PF,66,27,1448,207,394,0.525,0,3,0,207,391,0.529,0.525,79,113,0.699,143,225,368,74,21,35,77,213,493
184,Nick Collison,3,C,82,56,2378,318,636,0.5,0,2,0,318,634,0.502,0.5,154,199,0.774,229,437,666,82,48,66,123,289,790
184,Nick Collison,4,PF,78,35,2223,322,641,0.502,0,2,0,322,639,0.504,0.502,123,167,0.737,254,476,730,113,47,60,118,250,767
185,Marcus Banks,1,PG,81,2,1385,177,442,0.4,27,86,0.314,150,356,0.421,0.431,99,131,0.756,30,103,133,175,88,13,125,171,480
185,Marcus Banks,2,PG,81,2,1145,115,286,0.402,21,59,0.356,94,227,0.414,0.439,121,163,0.742,29,97,126,155,63,13,79,146,372
185,Marcus Banks,3,PG,58,29,1497,219,468,0.468,22,63,0.349,197,405,0.486,0.491,118,147,0.803,23,112,135,220,54,11,119,162,578
185,Marcus Banks,4,PG,18,1,269,33,80,0.413,6,19,0.316,27,61,0.443,0.45,27,30,0.9,4,15,19,32,7,0,23,38,99
186,Luke Ridnour,1,PG,69,6,1114,145,350,0.414,27,80,0.338,118,270,0.437,0.453,65,79,0.823,35,73,108,163,52,7,80,105,382
186,Luke Ridnour,2,PG,82,82,2571,299,739,0.405,67,178,0.376,232,561,0.414,0.45,159,180,0.883,55,149,204,483,94,23,149,185,824
186,Luke Ridnour,3,PG,79,77,2625,334,799,0.418,43,149,0.289,291,650,0.448,0.445,199,227,0.877,47,188,235,550,123,22,162,178,910
186,Luke Ridnour,4,PG,71,58,2091,301,695,0.433,49,139,0.353,252,556,0.453,0.468,128,159,0.805,28,136,164,368,83,19,156,181,779
187,Reece Gaines,1,PG,38,1,364,25,86,0.291,3,10,0.3,22,76,0.289,0.308,16,25,0.64,8,31,39,40,11,2,18,22,69
187,Reece Gaines,2,PG,21,0,187,17,50,0.34,4,14,0.286,13,36,0.361,0.38,3,4,0.75,1,13,14,7,5,1,7,17,41
187,Reece Gaines,3,PG,10,0,108,10,27,0.37,3,12,0.25,7,15,0.467,0.426,3,4,0.75,0,11,11,3,3,0,4,12,26
187,Reece Gaines,4,PG,11,0,79,7,23,0.304,1,2,0.5,6,21,0.286,0.326,0,0,,1,2,3,4,2,1,3,5,15
188,Troy Bell,1,PG,6,0,34,4,18,0.222,0,4,0,4,14,0.286,0.222,3,3,1,3,1,4,4,1,0,6,6,11
189,Zarko Cabarkapa,1,PF,49,4,570,81,197,0.411,6,32,0.188,75,165,0.455,0.426,35,53,0.66,26,73,99,40,10,13,54,75,203
189,Zarko Cabarkapa,2,PF,40,0,475,86,177,0.486,13,36,0.361,73,141,0.518,0.523,53,65,0.815,35,67,102,25,10,5,30,59,238
189,Zarko Cabarkapa,3,PF,3,0,11,4,7,0.571,0,0,,4,7,0.571,0.571,1,1,1,2,1,3,0,0,0,0,0,9
189,Zarko Cabarkapa,4,PF,37,0,464,82,170,0.482,13,36,0.361,69,134,0.515,0.521,52,64,0.813,33,66,99,25,10,5,30,59,229
190,David West,1,PF,71,1,930,108,228,0.474,0,2,0,108,226,0.478,0.474,57,80,0.713,117,180,297,60,27,28,48,117,273
190,David West,2,SF,30,8,552,75,172,0.436,2,5,0.4,73,167,0.437,0.442,34,50,0.68,40,89,129,23,12,16,37,62,186
190,David West,3,PF,74,74,2526,530,1036,0.512,3,11,0.273,527,1025,0.514,0.513,199,236,0.843,168,380,548,92,61,64,105,214,1262
190,David West,4,PF,52,52,1900,377,792,0.476,8,25,0.32,369,767,0.481,0.481,187,227,0.824,126,298,424,114,42,38,98,143,949
191,Sasha Pavlovic,1,SF,79,14,1144,149,376,0.396,19,70,0.271,130,306,0.425,0.422,65,84,0.774,44,115,159,60,41,16,67,187,382
191,Sasha Pavlovic,2,SG,65,9,862,120,276,0.435,30,78,0.385,90,198,0.455,0.489,44,64,0.688,15,56,71,49,29,4,47,121,314
191,Sasha Pavlovic,3,SG,53,19,813,87,212,0.41,35,96,0.365,52,116,0.448,0.493,32,49,0.653,16,64,80,25,19,6,42,103,241
191,Sasha Pavlovic,4,SG,67,28,1534,222,490,0.453,60,148,0.405,162,342,0.474,0.514,100,126,0.794,23,135,158,105,55,17,102,145,604
192,Dahntay Jones,1,SG,20,0,154,15,53,0.283,1,4,0.25,14,49,0.286,0.292,5,11,0.455,7,16,23,12,5,6,12,23,36
192,Dahntay Jones,2,SG,52,7,649,83,190,0.437,23,60,0.383,60,130,0.462,0.497,44,64,0.688,11,58,69,21,13,11,29,81,233
192,Dahntay Jones,3,SF,71,4,967,109,263,0.414,3,21,0.143,106,242,0.438,0.42,60,93,0.645,20,84,104,39,38,15,50,108,281
192,Dahntay Jones,4,SG,78,25,1671,220,461,0.477,5,12,0.417,215,449,0.479,0.483,138,174,0.793,47,106,153,68,39,22,92,192,583
193,Boris Diaw,1,SG,76,37,1919,140,313,0.447,6,26,0.231,134,287,0.467,0.457,56,93,0.602,111,231,342,182,59,37,126,191,342
193,Boris Diaw,2,SG,66,25,1201,124,294,0.422,9,50,0.18,115,244,0.471,0.437,57,77,0.74,54,116,170,149,37,18,87,123,314
193,Boris Diaw,3,PF,81,70,2874,449,853,0.526,8,30,0.267,441,823,0.536,0.531,174,238,0.731,159,399,558,503,58,85,189,260,1080
193,Boris Diaw,4,PF,73,59,2268,306,569,0.538,15,45,0.333,291,524,0.555,0.551,82,120,0.683,91,226,317,352,28,38,154,177,709
194,Zoran Planinic,1,SG,49,1,473,53,129,0.411,9,32,0.281,44,97,0.454,0.446,38,60,0.633,14,41,55,68,13,3,36,70,153
194,Zoran Planinic,2,PG,43,8,515,78,174,0.448,15,40,0.375,63,134,0.47,0.491,46,66,0.697,19,50,69,44,25,0,41,76,217
194,Zoran Planinic,3,PG,56,1,596,66,183,0.361,13,56,0.232,53,127,0.417,0.396,46,66,0.697,14,60,74,53,20,4,43,91,191
195,Travis Outlaw,1,PF,8,0,19,3,7,0.429,0,0,,3,7,0.429,0.429,2,4,0.5,2,2,4,1,1,0,1,1,8
195,Travis Outlaw,2,SF,59,2,793,133,267,0.498,4,10,0.4,129,257,0.502,0.506,49,75,0.653,40,81,121,35,30,40,39,77,319
195,Travis Outlaw,3,PF,69,11,1153,162,368,0.44,14,53,0.264,148,315,0.47,0.459,62,89,0.697,48,141,189,34,31,46,37,112,400
195,Travis Outlaw,4,PF,67,1,1532,246,567,0.434,10,37,0.27,236,530,0.445,0.443,143,181,0.79,65,152,217,52,61,74,66,150,645
196,Brian Cook,1,C,35,2,442,67,141,0.475,0,5,0,67,136,0.493,0.475,21,28,0.75,31,70,101,20,16,16,17,64,155
196,Brian Cook,2,C,72,0,1087,176,422,0.417,78,199,0.392,98,223,0.439,0.509,28,37,0.757,63,153,216,35,23,26,29,139,458
196,Brian Cook,3,PF,81,46,1535,261,511,0.511,36,84,0.429,225,427,0.527,0.546,84,101,0.832,88,186,274,74,37,32,61,205,642
196,Brian Cook,4,PF,65,24,1018,185,408,0.453,46,115,0.4,139,293,0.474,0.51,34,47,0.723,61,154,215,65,25,27,51,134,450
197,Carlos Delfino,1,SG,30,4,459,42,117,0.359,9,35,0.257,33,82,0.402,0.397,23,40,0.575,13,42,55,38,22,6,23,44,116
197,Carlos Delfino,2,SG,68,1,726,91,226,0.403,20,60,0.333,71,166,0.428,0.447,45,67,0.672,28,85,113,44,21,15,36,86,247
197,Carlos Delfino,3,SG,82,1,1372,156,376,0.415,46,138,0.333,110,238,0.462,0.476,70,89,0.787,67,199,266,88,46,8,61,97,428
197,Carlos Delfino,4,SG,82,0,1928,251,632,0.397,120,314,0.382,131,318,0.412,0.492,116,156,0.744,66,293,359,145,69,11,75,177,738
198,Ndudi Ebi,1,SF,17,0,32,6,14,0.429,0,0,,6,14,0.429,0.429,1,4,0.25,2,1,3,3,0,4,3,6,13
198,Ndudi Ebi,2,SG,2,0,54,11,21,0.524,0,1,0,11,20,0.55,0.524,5,9,0.556,6,10,16,1,1,1,3,7,27
199,Kendrick Perkins,1,C,10,0,35,8,15,0.533,0,0,,8,15,0.533,0.533,6,9,0.667,5,9,14,3,0,2,5,6,22
199,Kendrick Perkins,2,C,60,3,548,56,119,0.471,0,0,,56,119,0.471,0.471,37,58,0.638,53,123,176,21,9,37,43,98,149
199,Kendrick Perkins,3,C,68,40,1332,137,266,0.515,0,2,0,137,264,0.519,0.515,80,130,0.615,140,264,404,69,21,105,107,199,354
199,Kendrick Perkins,4,C,72,53,1576,132,269,0.491,0,3,0,132,266,0.496,0.491,60,100,0.6,113,259,372,94,23,96,113,214,324
200,Leandro Barbosa,1,PG,70,46,1500,210,470,0.447,83,210,0.395,127,260,0.488,0.535,47,61,0.77,23,100,123,165,93,7,120,184,550
200,Leandro Barbosa,2,PG,63,6,1087,168,354,0.475,51,139,0.367,117,215,0.544,0.547,55,69,0.797,32,98,130,126,30,7,87,127,442
200,Leandro Barbosa,3,SG,57,11,1592,273,567,0.481,87,196,0.444,186,371,0.501,0.558,111,147,0.755,31,119,150,158,48,6,89,145,744
200,Leandro Barbosa,4,SG,80,18,2613,529,1111,0.476,190,438,0.434,339,673,0.504,0.562,196,232,0.845,22,192,214,317,96,15,146,210,1444
201,Josh Howard,1,SF,67,29,1589,229,532,0.43,20,66,0.303,209,466,0.448,0.449,97,138,0.703,149,219,368,97,69,54,67,168,575
201,Josh Howard,2,SF,76,76,2446,377,793,0.475,34,115,0.296,343,678,0.506,0.497,170,232,0.733,169,315,484,109,116,49,122,211,958
201,Josh Howard,3,SF,59,58,1915,350,743,0.471,27,63,0.429,323,680,0.475,0.489,196,267,0.734,123,248,371,111,68,26,79,167,923
201,Josh Howard,4,SF,70,69,2455,493,1075,0.459,92,239,0.385,401,836,0.48,0.501,243,294,0.827,130,345,475,127,82,56,123,180,1321
202,Maciej Lampe,1,C,21,0,224,43,88,0.489,0,4,0,43,84,0.512,0.489,10,13,0.769,9,35,44,9,3,3,15,28,96
202,Maciej Lampe,2,C,37,0,380,49,132,0.371,2,4,0.5,47,128,0.367,0.379,15,22,0.682,24,65,89,11,5,7,17,51,115
202,Maciej Lampe,3,C,16,0,119,17,49,0.347,2,3,0.667,15,46,0.326,0.367,8,12,0.667,9,23,32,1,1,2,10,20,44
202,Maciej Lampe,4,C,21,0,261,32,83,0.386,0,1,0,32,82,0.39,0.386,7,10,0.7,15,42,57,10,4,5,7,31,71
203,Jason Kapono,1,SF,41,3,427,52,129,0.403,21,44,0.477,31,85,0.365,0.484,20,24,0.833,19,36,55,14,13,2,21,41,145
203,Jason Kapono,2,SF,81,14,1491,269,671,0.401,80,194,0.412,189,477,0.396,0.461,70,85,0.824,32,132,164,61,40,6,46,132,688
203,Jason Kapono,3,SF,51,2,665,79,177,0.446,21,53,0.396,58,124,0.468,0.506,28,33,0.848,12,59,71,37,7,3,20,89,207
203,Jason Kapono,4,SF,67,35,1767,278,563,0.494,108,210,0.514,170,353,0.482,0.59,66,74,0.892,26,154,180,81,38,2,70,135,730
204,Luke Walton,1,PF,72,2,730,65,153,0.425,13,39,0.333,52,114,0.456,0.467,31,44,0.705,39,88,127,113,28,8,44,70,174
204,Luke Walton,2,SF,61,5,768,74,180,0.411,16,61,0.262,58,119,0.487,0.456,34,48,0.708,55,87,142,93,26,11,58,70,198
204,Luke Walton,3,SF,69,6,1333,135,328,0.412,18,55,0.327,117,273,0.429,0.439,57,76,0.75,88,159,247,156,41,15,78,119,345
204,Luke Walton,4,SF,60,60,1982,264,557,0.474,48,124,0.387,216,433,0.499,0.517,108,145,0.745,87,215,302,257,60,21,118,117,684
205,Jerome Beasley,1,PF,2,0,5,1,3,0.333,0,0,,1,3,0.333,0.333,0,0,,0,1,1,0,0,0,0,0,2
206,Sofoklis Schortsanitis,No NBA Data,,,,,,,,,,,,,,,,,,,,,,,,,,
207,Szymon Szewczyk,No NBA Data,,,,,,,,,,,,,,,,,,,,,,,,,,
208,Mario Austin,No NBA Data,,,,,,,,,,,,,,,,,,,,,,,,,,
209,Travis Hansen,1,SF,41,4,507,46,130,0.354,9,30,0.3,37,100,0.37,0.388,22,27,0.815,30,40,70,19,10,9,15,67,123
210,Steve Blake,1,PG,75,14,1392,157,407,0.386,75,202,0.371,82,205,0.4,0.478,55,67,0.821,18,99,117,209,57,7,128,100,444
210,Steve Blake,2,PG,44,1,648,61,186,0.328,36,93,0.387,25,93,0.269,0.425,33,41,0.805,18,53,71,69,13,0,39,47,191
210,Steve Blake,3,PG,68,57,1781,206,470,0.438,76,184,0.413,130,286,0.455,0.519,72,91,0.791,26,120,146,306,42,5,83,107,560
210,Steve Blake,4,PG,82,42,2225,209,509,0.411,67,208,0.322,142,301,0.472,0.476,43,64,0.672,21,148,169,408,61,8,129,121,528
211,Slavko Vranes,1,C,1,0,3,0,1,0,0,0,,0,1,0,0,0,0,,0,0,0,0,0,0,0,1,0
212,Derrick Zimmerman,1,PG,2,0,32,2,3,0.667,0,0,,2,3,0.667,0.667,0,0,,1,3,4,7,0,0,4,4,4
213,Willie Green,1,SG,53,0,767,143,357,0.401,19,61,0.311,124,296,0.419,0.427,59,81,0.728,16,49,65,53,26,5,59,83,364
213,Willie Green,2,SG,57,21,1066,155,423,0.366,30,105,0.286,125,318,0.393,0.402,97,125,0.776,22,111,133,100,34,6,75,121,437
213,Willie Green,3,SG,10,2,153,28,66,0.424,10,19,0.526,18,47,0.383,0.5,4,5,0.8,1,14,15,5,2,0,12,13,70
213,Willie Green,4,SG,74,36,1842,357,868,0.411,51,157,0.325,306,711,0.43,0.441,74,111,0.667,42,116,158,112,56,4,106,144,839
214,Zaza Pachulia,1,C,59,2,664,68,175,0.389,0,0,,68,175,0.389,0.389,58,90,0.644,69,105,174,13,21,12,34,87,194
214,Zaza Pachulia,2,C,74,4,1397,160,354,0.452,0,1,0,160,353,0.453,0.452,138,185,0.746,131,247,378,60,44,34,70,166,458
214,Zaza Pachulia,3,C,78,78,2452,307,681,0.451,0,2,0,307,679,0.452,0.451,297,404,0.735,264,349,613,129,89,39,180,286,911
214,Zaza Pachulia,4,C,72,47,2026,291,614,0.474,0,1,0,291,613,0.475,0.474,293,373,0.786,199,301,500,106,77,36,162,267,875
215,Keith Bogans,1,SF,73,36,1787,183,454,0.403,67,187,0.358,116,267,0.434,0.477,65,103,0.631,106,211,317,98,46,10,75,128,498
215,Keith Bogans,2,SG,74,42,1791,262,688,0.381,57,173,0.329,205,515,0.398,0.422,133,183,0.727,76,150,226,135,68,8,122,167,714
215,Keith Bogans,3,SG-SF,72,31,1912,215,544,0.395,65,200,0.325,150,344,0.436,0.455,127,186,0.683,55,200,255,128,71,9,90,167,622
215,Keith Bogans,4,SG,39,9,848,114,288,0.396,33,98,0.337,81,190,0.426,0.453,80,105,0.762,29,77,106,45,39,3,41,78,341
216,Malick Badiane,No NBA Data,,,,,,,,,,,,,,,,,,,,,,,,,,
217,Matt Bonner,1,C,82,0,1553,247,463,0.533,39,92,0.424,208,371,0.561,0.576,56,71,0.789,108,177,285,48,39,19,40,220,589
217,Matt Bonner,2,PF,78,6,1710,209,467,0.448,102,243,0.42,107,224,0.478,0.557,63,76,0.829,86,198,284,56,49,31,32,216,583
217,Matt Bonner,3,PF,56,0,653,106,237,0.447,36,94,0.383,70,143,0.49,0.523,27,38,0.711,64,92,156,22,17,11,25,67,275
217,Matt Bonner,4,PF,68,3,853,121,291,0.416,46,137,0.336,75,154,0.487,0.495,38,44,0.864,53,139,192,32,14,17,39,111,326
218,Sani Becirovic,No NBA Data,,,,,,,,,,,,,,,,,,,,,,,,,,
219,Mo Williams,1,SG,57,0,772,115,303,0.38,10,39,0.256,105,264,0.398,0.396,44,56,0.786,23,49,72,76,28,2,51,87,284
219,Mo Williams,2,PG,80,80,2254,323,737,0.438,32,99,0.323,291,638,0.456,0.46,136,160,0.85,50,194,244,484,74,11,196,221,814
219,Mo Williams,3,PG,58,12,1531,267,629,0.424,73,191,0.382,194,438,0.443,0.483,96,113,0.85,30,113,143,230,52,7,105,146,703
219,Mo Williams,4,PG,68,68,2472,468,1049,0.446,79,228,0.346,389,821,0.474,0.484,159,186,0.855,54,275,329,416,85,6,203,201,1174
220,James Lang,1,C,11,0,55,4,9,0.444,0,0,,4,9,0.444,0.444,3,5,0.6,5,6,11,2,0,3,2,14,11
221,James Jones,1,SF,6,0,26,2,9,0.222,1,4,0.25,1,5,0.2,0.278,2,2,1,0,2,2,0,1,0,0,1,7
221,James Jones,2,SF,75,24,1330,126,318,0.396,66,166,0.398,60,152,0.395,0.5,53,62,0.855,39,135,174,57,31,28,43,123,371
221,James Jones,3,SF,75,24,1772,243,581,0.418,110,285,0.386,133,296,0.449,0.513,103,121,0.851,44,209,253,57,38,49,35,142,699
221,James Jones,4,SF,76,7,1376,162,440,0.368,90,238,0.378,72,202,0.356,0.47,71,81,0.877,33,143,176,45,28,42,28,115,485
222,Paccelis Morlende,No NBA Data,,,,,,,,,,,,,,,,,,,,,,,,,,
223,Kyle Korver,1,SF,74,0,882,115,327,0.352,81,207,0.391,34,120,0.283,0.476,19,24,0.792,30,81,111,40,25,8,41,102,330
223,Kyle Korver,2,SF,82,57,2667,317,759,0.418,226,558,0.405,91,201,0.453,0.567,82,96,0.854,40,339,379,182,103,33,106,265,942
223,Kyle Korver,3,SF,82,43,2563,327,761,0.43,184,438,0.42,143,323,0.443,0.551,101,119,0.849,27,243,270,163,65,26,98,224,939
223,Kyle Korver,4,SF,74,1,2288,372,845,0.44,132,307,0.43,240,538,0.446,0.518,191,209,0.914,30,229,259,105,57,20,117,188,1067
224,Remon Van de Hare,No NBA Data,,,,,,,,,,,,,,,,,,,,,,,,,,
225,Tommy Smith,No NBA Data,,,,,,,,,,,,,,,,,,,,,,,,,,
226,Nedzad Sinanovic,No NBA Data,,,,,,,,,,,,,,,,,,,,,,,,,,
227,Rick Rickert,No NBA Data,,,,,,,,,,,,,,,,,,,,,,,,,,
228,Brandon Hunter,1,PF,36,12,406,53,116,0.457,0,3,0,53,113,0.469,0.457,19,43,0.442,50,68,118,19,13,1,22,40,125
228,Brandon Hunter,2,PF,31,0,224,37,73,0.507,0,0,,37,73,0.507,0.507,21,39,0.538,25,44,69,3,4,7,22,42,95
229,Xue Yuyang,No NBA Data,,,,,,,,,,,,,,,,,,,,,,,,,,
230,Andreas Glyniadakis,1,C,13,4,81,8,17,0.471,0,0,,8,17,0.471,0.471,1,2,0.5,2,6,8,1,0,0,9,19,17
231,Dwight Howard,1,PF,82,82,2670,352,677,0.52,0,2,0,352,675,0.521,0.52,277,413,0.671,287,536,823,75,77,136,165,232,981
231,Dwight Howard,2,PF,82,81,3021,468,881,0.531,0,2,0,468,879,0.532,0.531,356,598,0.595,288,734,1022,125,65,115,217,277,1292
231,Dwight Howard,3,C,82,82,3023,526,873,0.603,1,2,0.5,525,871,0.603,0.603,390,666,0.586,283,725,1008,158,70,156,317,245,1443
231,Dwight Howard,4,C,82,82,3088,583,974,0.599,0,4,0,583,970,0.601,0.599,529,897,0.59,279,882,1161,110,74,176,263,274,1695
232,Emeka Okafor,1,PF,73,73,2600,448,1003,0.447,0,1,0,448,1002,0.447,0.447,209,343,0.609,275,520,795,64,62,125,125,214,1105
232,Emeka Okafor,2,PF,26,25,874,131,316,0.415,0,0,,131,316,0.415,0.415,82,125,0.656,94,167,261,31,22,50,53,88,344
232,Emeka Okafor,3,C,67,65,2329,394,740,0.532,0,0,,394,740,0.532,0.532,175,295,0.593,258,499,757,80,57,172,111,210,963
232,Emeka Okafor,4,C,82,82,2718,460,860,0.535,0,0,,460,860,0.535,0.535,213,374,0.57,255,621,876,70,62,138,164,241,1133
233,Ben Gordon,1,SG,82,3,2002,434,1056,0.411,134,331,0.405,300,725,0.414,0.474,233,270,0.863,55,160,215,164,53,10,186,224,1235
233,Ben Gordon,2,SG,80,47,2482,486,1152,0.422,166,382,0.435,320,770,0.416,0.494,211,268,0.787,43,176,219,240,75,5,180,238,1349
233,Ben Gordon,3,SG,82,51,2704,609,1338,0.455,155,375,0.413,454,963,0.471,0.513,380,440,0.864,35,223,258,296,64,17,249,252,1753
233,Ben Gordon,4,SG,72,27,2291,464,1069,0.434,142,346,0.41,322,723,0.445,0.5,266,293,0.908,40,181,221,213,55,8,150,171,1336
234,Shaun Livingston,1,PG,30,15,814,89,215,0.414,0,2,0,89,213,0.418,0.414,44,59,0.746,22,67,89,151,32,11,75,82,222
234,Shaun Livingston,2,PG,61,14,1525,149,349,0.427,1,8,0.125,148,341,0.434,0.428,53,77,0.688,41,142,183,273,46,32,111,160,352
234,Shaun Livingston,3,PG,54,31,1611,208,449,0.463,5,16,0.313,203,433,0.469,0.469,82,116,0.707,56,128,184,274,59,29,108,135,503
234,Shaun Livingston,4,PG,12,1,231,31,60,0.517,0,0,,31,60,0.517,0.517,9,10,0.9,3,25,28,20,7,2,9,12,71
235,Devin Harris,1,PG,76,19,1173,157,366,0.429,44,131,0.336,113,235,0.481,0.489,78,103,0.757,28,74,102,169,77,19,82,139,436
235,Devin Harris,2,PG,56,4,1275,190,405,0.469,5,21,0.238,185,384,0.482,0.475,169,236,0.716,26,99,125,177,53,16,84,121,554
235,Devin Harris,3,PG,80,61,2081,292,593,0.492,14,50,0.28,278,543,0.512,0.504,215,261,0.824,45,151,196,296,96,21,146,242,813
235,Devin Harris,4,PG,64,61,2022,321,693,0.463,56,167,0.335,265,526,0.504,0.504,248,301,0.824,28,145,173,369,90,10,161,190,946
236,Josh Childress,1,SG,80,44,2376,302,642,0.47,13,56,0.232,289,586,0.493,0.481,190,231,0.823,195,287,482,151,74,35,106,184,807
236,Josh Childress,2,SF,74,10,2249,278,504,0.552,32,65,0.492,246,439,0.56,0.583,154,201,0.766,134,253,387,131,86,39,101,184,742
236,Josh Childress,3,SG,55,13,2024,261,518,0.504,26,77,0.338,235,441,0.533,0.529,167,210,0.795,123,217,340,127,58,36,80,118,715
236,Josh Childress,4,SF,76,0,2274,327,573,0.571,22,60,0.367,305,513,0.595,0.59,222,275,0.807,174,199,373,117,71,43,98,129,898
237,Luol Deng,1,SF,61,45,1663,280,645,0.434,31,117,0.265,249,528,0.472,0.458,120,162,0.741,92,230,322,135,48,27,118,98,711
237,Luol Deng,2,SF,78,56,2604,442,954,0.463,21,78,0.269,421,876,0.481,0.474,207,276,0.75,127,389,516,147,72,50,105,128,1112
237,Luol Deng,3,SF,82,82,3071,630,1218,0.517,1,7,0.143,629,1211,0.519,0.518,279,359,0.777,148,431,579,204,97,48,153,167,1540
237,Luol Deng,4,SF,63,59,2128,429,896,0.479,8,22,0.364,421,874,0.482,0.483,204,265,0.77,136,258,394,155,57,29,120,117,1070
238,Rafael Araujo,1,C,59,41,736,76,175,0.434,1,3,0.333,75,172,0.436,0.437,43,55,0.782,59,126,185,16,21,8,52,157,196
238,Rafael Araujo,2,C,52,34,601,53,145,0.366,0,1,0,53,144,0.368,0.366,15,28,0.536,43,101,144,15,24,6,42,104,121
238,Rafael Araujo,3,C,28,0,248,27,65,0.415,0,0,,27,65,0.415,0.415,18,29,0.621,22,44,66,10,6,2,17,39,72
239,Andre Iguodala,1,SG,82,82,2686,269,546,0.493,47,142,0.331,222,404,0.55,0.536,156,210,0.743,89,375,464,246,138,48,139,204,741
239,Andre Iguodala,2,SF,82,82,3086,344,688,0.5,56,158,0.354,288,530,0.543,0.541,263,349,0.754,117,364,481,255,135,21,153,198,1007
239,Andre Iguodala,3,SG,76,76,3062,443,991,0.447,48,155,0.31,395,836,0.472,0.471,452,551,0.82,77,357,434,432,152,33,261,200,1386
239,Andre Iguodala,4,SF,82,82,3242,582,1277,0.456,101,307,0.329,481,970,0.496,0.495,365,506,0.721,85,361,446,391,171,49,214,187,1630
240,Luke Jackson,1,SF,10,0,43,10,27,0.37,4,6,0.667,6,21,0.286,0.444,5,6,0.833,2,4,6,3,0,0,2,4,29
240,Luke Jackson,2,SF,36,0,315,29,85,0.341,12,36,0.333,17,49,0.347,0.412,26,33,0.788,16,24,40,25,11,2,31,30,96
240,Luke Jackson,3,SF,13,2,138,19,43,0.442,5,17,0.294,14,26,0.538,0.5,5,9,0.556,2,8,10,13,5,1,7,15,48
240,Luke Jackson,4,SF,3,0,16,1,8,0.125,1,4,0.25,0,4,0,0.188,0,0,,0,1,1,4,0,0,1,3,3
241,Andris Biedrins,1,C,30,1,384,45,78,0.577,0,1,0,45,77,0.584,0.577,19,40,0.475,47,71,118,12,12,24,12,87,109
241,Andris Biedrins,2,C,68,2,1000,118,185,0.638,0,0,,118,185,0.638,0.638,22,72,0.306,124,159,283,24,23,47,34,190,258
241,Andris Biedrins,3,C,82,63,2382,348,581,0.599,0,0,,348,581,0.599,0.599,87,167,0.521,251,511,762,88,67,136,119,304,783
241,Andris Biedrins,4,C,76,59,2078,340,543,0.626,0,0,,340,543,0.626,0.626,116,187,0.62,256,488,744,75,56,94,85,262,796
242,Robert Swift,1,C,16,0,72,5,11,0.455,0,0,,5,11,0.455,0.455,5,9,0.556,1,4,5,2,1,7,4,16,15
242,Robert Swift,2,C,47,20,987,124,241,0.515,0,0,,124,241,0.515,0.515,53,91,0.582,94,170,264,8,15,56,49,142,301
242,Robert Swift,3,C,8,4,98,6,17,0.353,0,0,,6,17,0.353,0.353,2,2,1,6,12,18,1,5,6,10,16,14
242,Robert Swift,4,C,26,10,343,37,71,0.521,0,0,,37,71,0.521,0.521,12,16,0.75,21,68,89,9,5,17,8,50,86
243,Sebastian Telfair,1,PG,68,26,1330,169,430,0.393,17,69,0.246,152,361,0.421,0.413,105,133,0.789,10,94,104,224,35,4,125,120,460
243,Sebastian Telfair,2,PG,68,30,1641,228,578,0.394,57,162,0.352,171,416,0.411,0.444,130,175,0.743,19,101,120,247,66,6,115,167,643
243,Sebastian Telfair,3,PG,78,30,1578,176,474,0.371,37,128,0.289,139,346,0.402,0.41,90,110,0.818,17,91,108,218,43,11,98,166,479
243,Sebastian Telfair,4,PG,60,51,1933,223,556,0.401,32,114,0.281,191,442,0.432,0.43,78,105,0.743,16,119,135,355,59,11,111,171,556
244,Kris Humphries,1,PF,67,4,873,116,287,0.404,2,6,0.333,114,281,0.406,0.408,44,101,0.436,73,124,197,43,25,18,52,96,278
244,Kris Humphries,2,PF,62,2,619,77,203,0.379,0,5,0,77,198,0.389,0.379,34,65,0.523,56,101,157,30,23,16,31,82,188
244,Kris Humphries,3,PF,60,2,670,87,185,0.47,0,0,,87,185,0.47,0.47,53,79,0.671,78,109,187,18,14,21,32,98,227
244,Kris Humphries,4,PF,70,0,925,161,333,0.483,0,2,0,161,331,0.486,0.483,75,124,0.605,90,169,259,28,25,28,47,107,397
245,Al Jefferson,1,PF,71,1,1051,195,369,0.528,0,3,0,195,366,0.533,0.528,85,135,0.63,119,193,312,24,22,55,66,195,475
245,Al Jefferson,2,PF,59,7,1062,189,379,0.499,0,4,0,189,375,0.504,0.499,86,134,0.642,97,202,299,30,30,46,62,166,464
245,Al Jefferson,3,C,69,60,2319,453,882,0.514,0,1,0,453,881,0.514,0.514,201,295,0.681,237,519,756,88,48,106,136,232,1107
245,Al Jefferson,4,C,82,82,2919,721,1441,0.5,0,5,0,721,1436,0.502,0.5,284,394,0.721,308,603,911,117,74,119,167,222,1726
246,Kirk Snyder,1,SG,68,7,906,122,328,0.372,30,85,0.353,92,243,0.379,0.418,64,96,0.667,50,71,121,36,26,19,58,116,338
246,Kirk Snyder,2,SG,68,45,1310,205,453,0.453,46,129,0.357,159,324,0.491,0.503,86,117,0.735,55,106,161,102,29,23,70,106,542
246,Kirk Snyder,3,SF,39,1,563,66,146,0.452,11,44,0.25,55,102,0.539,0.49,49,75,0.653,17,66,83,39,11,12,26,51,192
246,Kirk Snyder,4,SF-PF,36,18,761,96,189,0.508,5,23,0.217,91,166,0.548,0.521,64,88,0.727,30,96,126,64,20,15,52,55,261
247,Josh Smith,1,SF,74,59,2050,274,602,0.455,4,23,0.174,270,579,0.466,0.458,163,237,0.688,147,310,457,127,59,144,135,157,715
247,Josh Smith,2,SF,80,73,2559,329,774,0.425,34,110,0.309,295,664,0.444,0.447,210,292,0.719,176,355,531,191,64,208,162,260,902
247,Josh Smith,3,SF,72,72,2647,436,993,0.439,38,152,0.25,398,841,0.473,0.458,268,387,0.693,165,456,621,236,101,207,227,241,1178
247,Josh Smith,4,PF,81,81,2873,518,1133,0.457,25,99,0.253,493,1034,0.477,0.468,333,469,0.71,161,506,667,272,123,227,245,269,1394
248,J.R. Smith,1,SG,76,56,1859,295,748,0.394,81,281,0.288,214,467,0.458,0.449,111,161,0.689,39,113,152,142,55,11,109,135,782
248,J.R. Smith,2,SG,55,25,989,144,366,0.393,52,140,0.371,92,226,0.407,0.464,83,101,0.822,19,91,110,58,37,4,54,90,423
248,J.R. Smith,3,SG,63,24,1471,284,644,0.441,149,382,0.39,135,262,0.515,0.557,102,126,0.81,30,113,143,91,49,9,85,147,819
248,J.R. Smith,4,SG,74,0,1421,311,674,0.461,157,390,0.403,154,284,0.542,0.578,128,178,0.719,43,109,152,128,62,12,112,144,907
249,Dorell Wright,1,SF,3,0,27,3,11,0.273,0,4,0,3,7,0.429,0.273,1,1,1,0,1,1,3,4,0,3,2,7
249,Dorell Wright,2,SF,20,2,132,20,43,0.465,3,6,0.5,17,37,0.459,0.5,15,17,0.882,2,30,32,8,3,1,14,12,58
249,Dorell Wright,3,SF,66,19,1292,162,364,0.445,5,34,0.147,157,330,0.476,0.452,64,86,0.744,40,232,272,95,41,46,65,112,393
249,Dorell Wright,4,SF,44,34,1104,143,293,0.488,4,11,0.364,139,282,0.493,0.495,57,69,0.826,48,172,220,60,29,41,29,79,347
250,Jameer Nelson,1,PG,79,21,1612,286,628,0.455,44,141,0.312,242,487,0.497,0.49,73,107,0.682,52,141,193,237,78,3,117,199,689
250,Jameer Nelson,2,PG,62,33,1784,347,719,0.483,70,165,0.424,277,554,0.5,0.531,141,181,0.779,39,141,180,302,70,9,148,174,905
250,Jameer Nelson,3,PG,77,77,2331,376,875,0.43,65,194,0.335,311,681,0.457,0.467,183,221,0.828,50,186,236,330,73,5,184,225,1000
250,Jameer Nelson,4,PG,69,62,1961,283,603,0.469,64,154,0.416,219,449,0.488,0.522,125,151,0.828,28,215,243,383,63,4,141,167,755
251,Pavel Podkolzin,1,C,5,0,10,0,0,,0,0,,0,0,,,1,2,0.5,0,2,2,0,0,0,2,4,1
251,Pavel Podkolzin,2,C,1,0,18,0,2,0,0,0,,0,2,0,0,3,6,0.5,0,7,7,0,0,1,2,0,3
252,Viktor Khryapa,1,SF,32,5,523,54,124,0.435,4,11,0.364,50,113,0.442,0.452,23,42,0.548,28,80,108,25,20,18,33,80,135
252,Viktor Khryapa,2,SF,69,53,1492,158,342,0.462,10,30,0.333,148,312,0.474,0.477,77,111,0.694,114,193,307,88,50,29,84,209,403
252,Viktor Khryapa,3,PF,33,0,231,27,70,0.386,0,6,0,27,64,0.422,0.386,19,26,0.731,20,37,57,21,10,1,16,53,73
252,Viktor Khryapa,4,PF,9,0,105,12,31,0.387,0,1,0,12,30,0.4,0.387,8,14,0.571,6,14,20,8,6,0,6,11,32
253,Sergei Monia,1,SF,26,15,343,29,87,0.333,9,34,0.265,20,53,0.377,0.385,10,14,0.714,11,41,52,19,7,5,12,41,77
253,Sergei Monia,2,SF,23,15,336,29,85,0.341,9,33,0.273,20,52,0.385,0.394,8,12,0.667,11,40,51,19,6,5,12,41,75
253,Sergei Monia,3,SF,3,0,7,0,2,0,0,1,0,0,1,0,0,2,2,1,0,1,1,0,1,0,0,0,2
254,Delonte West,1,SG,39,7,507,66,155,0.426,24,67,0.358,42,88,0.477,0.503,19,27,0.704,14,51,65,53,21,8,24,69,175
254,Delonte West,2,PG,71,71,2418,333,684,0.487,84,218,0.385,249,466,0.534,0.548,86,101,0.851,57,232,289,329,84,46,133,197,836
254,Delonte West,3,SG,69,47,2219,306,717,0.427,65,178,0.365,241,539,0.447,0.472,168,197,0.853,32,176,208,304,74,34,140,152,845
254,Delonte West,4,PG,61,31,1533,196,475,0.413,48,135,0.356,148,340,0.435,0.463,67,91,0.736,31,162,193,229,59,29,117,103,507
255,Tony Allen,1,SG,77,34,1262,184,387,0.475,12,31,0.387,172,356,0.483,0.491,112,152,0.737,85,136,221,64,76,24,77,156,492
255,Tony Allen,2,PG,51,9,978,129,274,0.471,11,34,0.324,118,240,0.492,0.491,100,134,0.746,32,79,111,67,51,18,67,126,369
255,Tony Allen,3,SG,33,18,805,133,259,0.514,8,33,0.242,125,226,0.553,0.529,105,134,0.784,35,89,124,56,49,12,75,87,379
255,Tony Allen,4,SG,75,11,1373,169,389,0.434,18,57,0.316,151,332,0.455,0.458,138,181,0.762,34,134,168,114,62,21,109,168,494
256,Kevin Martin,1,PG,45,0,455,45,117,0.385,5,25,0.2,40,92,0.435,0.406,36,55,0.655,29,29,58,22,16,3,24,35,131
256,Kevin Martin,2,SG,72,41,1913,262,546,0.48,66,179,0.369,196,367,0.534,0.54,188,222,0.847,58,203,261,97,55,9,81,138,778
256,Kevin Martin,3,SG,80,80,2818,505,1067,0.473,127,333,0.381,378,734,0.515,0.533,481,570,0.844,69,273,342,173,98,11,135,181,1618
256,Kevin Martin,4,SG,61,57,2216,417,914,0.456,107,266,0.402,310,648,0.478,0.515,502,578,0.869,48,225,273,129,62,5,131,150,1443
257,Sasha Vujacic,1,SG,35,3,403,33,117,0.282,17,63,0.27,16,54,0.296,0.355,18,19,0.947,13,49,62,51,12,2,15,41,101
257,Sasha Vujacic,2,PG,82,4,1449,108,312,0.346,59,172,0.343,49,140,0.35,0.441,46,52,0.885,33,126,159,139,48,3,50,150,321
257,Sasha Vujacic,3,SG,73,4,935,105,268,0.392,60,161,0.373,45,107,0.421,0.504,43,49,0.878,28,79,107,64,41,1,30,103,313
257,Sasha Vujacic,4,SG,72,0,1279,219,482,0.454,118,270,0.437,101,212,0.476,0.577,76,91,0.835,19,135,154,72,36,5,52,107,632
258,Beno Udrih,1,PG,80,2,1149,173,390,0.444,58,142,0.408,115,248,0.464,0.518,67,89,0.753,16,67,83,150,41,10,77,96,471
258,Beno Udrih,2,PG,54,3,586,106,233,0.455,24,70,0.343,82,163,0.503,0.506,39,50,0.78,18,34,52,92,14,2,53,55,275
258,Beno Udrih,3,PG,73,1,948,127,344,0.369,33,115,0.287,94,229,0.41,0.417,53,60,0.883,11,71,82,122,27,1,56,70,340
258,Beno Udrih,4,PG,65,51,2080,328,708,0.463,53,137,0.387,275,571,0.482,0.501,125,147,0.85,34,183,217,282,56,10,148,138,834
259,David Harrison,1,C,43,14,760,106,184,0.576,0,0,,106,184,0.576,0.576,52,91,0.571,48,87,135,13,16,55,53,134,264
259,David Harrison,2,C,67,17,1034,148,294,0.503,0,0,,148,294,0.503,0.503,89,174,0.511,84,170,254,14,23,59,79,193,385
259,David Harrison,3,C,24,2,190,30,58,0.517,0,0,,30,58,0.517,0.517,11,22,0.5,9,33,42,6,5,12,26,47,71
259,David Harrison,4,C,55,0,702,90,170,0.529,0,0,,90,170,0.529,0.529,49,96,0.51,43,75,118,14,20,59,58,164,229
260,Anderson Varejao,1,PF,54,0,863,99,193,0.513,0,2,0,99,191,0.518,0.513,68,127,0.535,109,148,257,27,41,38,26,122,266
260,Anderson Varejao,2,C,48,4,760,79,150,0.527,0,1,0,79,149,0.53,0.527,61,119,0.513,77,158,235,19,31,19,27,118,219
260,Anderson Varejao,3,C,81,6,1932,191,401,0.476,0,9,0,191,392,0.487,0.476,165,268,0.616,191,354,545,75,76,52,67,269,547
260,Anderson Varejao,4,C,48,13,1320,136,295,0.461,0,2,0,136,293,0.464,0.461,49,82,0.598,134,265,399,53,37,26,59,134,321
261,Jackson Vroman,1,C-PF,46,18,705,82,199,0.412,0,3,0,82,196,0.418,0.412,48,75,0.64,64,111,175,40,25,19,64,105,212
261,Jackson Vroman,2,PF,10,1,57,6,16,0.375,0,0,,6,16,0.375,0.375,4,7,0.571,5,8,13,7,3,2,7,11,16
261,Jackson Vroman,3,C,36,17,648,76,183,0.415,0,3,0,76,180,0.422,0.415,44,68,0.647,59,103,162,33,22,17,57,94,196
261,Jackson Vroman,4,PF,41,2,406,26,66,0.394,0,0,,26,66,0.394,0.394,21,44,0.477,33,53,86,11,12,11,21,78,73
262,Peter John Ramos,1,C,6,0,20,5,10,0.5,0,0,,5,10,0.5,0.5,1,2,0.5,1,3,4,0,0,1,3,4,11
263,Lionel Chalmers,1,PG,36,0,433,42,125,0.336,12,49,0.245,30,76,0.395,0.384,15,24,0.625,4,27,31,51,13,0,24,30,111
264,Donta Smith,1,SG,38,0,433,44,113,0.389,6,22,0.273,38,91,0.418,0.416,33,48,0.688,19,33,52,39,23,5,25,50,127
264,Donta Smith,2,SG,23,0,127,15,27,0.556,2,4,0.5,13,23,0.565,0.593,6,12,0.5,3,11,14,9,8,0,4,20,38
265,Andre Emmett,1,SG,8,0,28,2,6,0.333,0,0,,2,6,0.333,0.333,3,5,0.6,0,2,2,0,0,0,1,4,7
265,Andre Emmett,2,SF,6,0,45,4,7,0.571,0,1,0,4,6,0.667,0.571,5,8,0.625,2,4,6,1,2,1,2,2,13
266,Antonio Burks,1,PG,24,0,219,28,60,0.467,3,11,0.273,25,49,0.51,0.492,14,19,0.737,1,11,12,28,13,1,12,25,73
266,Antonio Burks,2,PG,57,1,570,51,144,0.354,1,6,0.167,50,138,0.362,0.358,10,23,0.435,4,33,37,76,20,0,36,45,113
267,Royal Ivey,1,PG,62,5,809,85,198,0.429,3,9,0.333,82,189,0.434,0.437,47,67,0.701,19,65,84,103,39,7,58,140,220
267,Royal Ivey,2,PG,73,66,978,116,264,0.439,4,10,0.4,112,254,0.441,0.447,24,33,0.727,31,65,96,74,24,7,23,147,260
267,Royal Ivey,3,PG,53,18,539,64,143,0.448,5,16,0.313,59,127,0.465,0.465,24,35,0.686,15,36,51,45,24,4,31,62,157
267,Royal Ivey,4,PG,75,20,1437,149,378,0.394,35,107,0.327,114,271,0.421,0.44,85,117,0.726,38,80,118,160,45,7,75,166,418
268,Chris Duhon,1,PG,82,73,2177,172,488,0.352,94,265,0.355,78,223,0.35,0.449,49,67,0.731,23,190,213,398,82,3,119,205,487
268,Chris Duhon,2,PG,74,38,2155,215,538,0.4,100,278,0.36,115,260,0.442,0.493,117,143,0.818,28,192,220,373,70,3,117,152,647
268,Chris Duhon,3,PG,78,30,1906,197,483,0.408,88,245,0.359,109,238,0.458,0.499,76,101,0.752,23,146,169,310,69,6,105,150,558
268,Chris Duhon,4,PG,66,18,1490,133,344,0.387,54,155,0.348,79,189,0.418,0.465,65,80,0.813,19,97,116,263,48,2,71,92,385
269,Albert Miralles,No NBA Data,,,,,,,,,,,,,,,,,,,,,,,,,,
270,Justin Reed,1,SF,23,0,121,15,29,0.517,0,3,0,15,26,0.577,0.517,11,15,0.733,8,8,16,10,3,1,5,12,41
270,Justin Reed,2,SF,72,6,997,119,295,0.403,0,1,0,119,294,0.405,0.403,87,120,0.725,53,71,124,41,23,15,52,163,325
270,Justin Reed,3,SF,32,0,291,25,74,0.338,0,0,,25,74,0.338,0.338,25,40,0.625,13,16,29,7,5,4,15,45,75
270,Justin Reed,4,SF,40,6,706,94,221,0.425,0,1,0,94,220,0.427,0.425,62,80,0.775,40,55,95,34,18,11,37,118,250
271,David Young,No NBA Data,,,,,,,,,,,,,,,,,,,,,,,,,,
272,Viktor Sanikidze,No NBA Data,,,,,,,,,,,,,,,,,,,,,,,,,,
273,Trevor Ariza,1,SF,80,12,1382,172,389,0.442,3,13,0.231,169,376,0.449,0.446,121,174,0.695,89,153,242,85,70,18,73,150,468
273,Trevor Ariza,2,SF,57,10,999,93,226,0.412,1,5,0.2,92,221,0.416,0.414,77,127,0.606,78,140,218,61,57,11,62,100,264
273,Trevor Ariza,3,SF,36,10,709,61,146,0.418,1,3,0.333,60,143,0.42,0.421,42,77,0.545,49,88,137,46,43,9,46,78,165
273,Trevor Ariza,4,SF,21,0,290,32,80,0.4,0,2,0,32,78,0.41,0.4,35,50,0.7,29,52,81,15,14,2,16,22,99
274,Tim Pickett,No NBA Data,,,,,,,,,,,,,,,,,,,,,,,,,,
275,Bernard Robinson,1,SG,31,1,328,36,81,0.444,3,8,0.375,33,73,0.452,0.463,18,26,0.692,14,34,48,30,11,4,20,42,93
275,Bernard Robinson,2,SF,66,18,1303,157,365,0.43,2,21,0.095,155,344,0.451,0.433,106,134,0.791,62,157,219,77,81,10,74,141,422
275,Bernard Robinson,3,SG-SF,31,0,278,19,62,0.306,0,2,0,19,60,0.317,0.306,23,27,0.852,10,38,48,19,17,2,16,32,61
275,Bernard Robinson,4,SG,21,0,241,16,54,0.296,0,2,0,16,52,0.308,0.296,19,22,0.864,9,33,42,17,13,1,16,28,51
276,Ha Seung-Jin,1,C,19,0,104,10,23,0.435,0,0,,10,23,0.435,0.435,6,11,0.545,6,12,18,2,1,5,12,21,26
276,Ha Seung-Jin,2,C,27,4,212,18,31,0.581,0,0,,18,31,0.581,0.581,8,17,0.471,14,35,49,1,3,8,14,41,44
277,Pape Sow,1,C,27,4,255,23,58,0.397,0,0,,23,58,0.397,0.397,16,27,0.593,18,39,57,2,12,4,10,46,62
277,Pape Sow,2,C,42,25,590,53,123,0.431,0,0,,53,123,0.431,0.431,41,57,0.719,54,92,146,8,21,19,30,118,147
277,Pape Sow,3,C,7,0,34,3,9,0.333,0,0,,3,9,0.333,0.333,4,6,0.667,6,5,11,2,1,1,1,2,10
278,Ricky Minard,No NBA Data,,,,,,,,,,,,,,,,,,,,,,,,,,
279,Sergei Lishouk,No NBA Data,,,,,,,,,,,,,,,,,,,,,,,,,,
280,Vassilis Spanoulis,1,SG,31,0,272,23,72,0.319,5,29,0.172,18,43,0.419,0.354,34,42,0.81,5,17,22,28,7,1,29,33,85
281,Christian Drejer,No NBA Data,,,,,,,,,,,,,,,,,,,,,,,,,,
282,Romain Sato,No NBA Data,,,,,,,,,,,,,,,,,,,,,,,,,,
283,Matt Freije,1,PF,23,11,441,37,127,0.291,14,54,0.259,23,73,0.315,0.346,5,8,0.625,16,45,61,20,13,2,17,40,93
283,Matt Freije,2,PF,19,0,147,16,54,0.296,3,22,0.136,13,32,0.406,0.324,5,6,0.833,8,16,24,7,3,1,3,13,40
284,Rickey Paulding,No NBA Data,,,,,,,,,,,,,,,,,,,,,,,,,,
285,Luis Flores,1,PG,16,0,77,14,29,0.483,5,10,0.5,9,19,0.474,0.569,2,2,1,1,2,3,11,2,0,11,9,35
285,Luis Flores,2,PG,15,0,73,13,27,0.481,4,9,0.444,9,18,0.5,0.556,2,2,1,0,2,2,11,2,0,11,9,32
285,Luis Flores,3,PG,1,0,4,1,2,0.5,1,1,1,0,1,0,0.75,0,0,,1,0,1,0,0,0,0,0,3
286,Marcus Douthit,No NBA Data,,,,,,,,,,,,,,,,,,,,,,,,,,
287,Sergei Karaulov,No NBA Data,,,,,,,,,,,,,,,,,,,,,,,,,,
288,Blake Stepp,No NBA Data,,,,,,,,,,,,,,,,,,,,,,,,,,
289,Rashad Wright,No NBA Data,,,,,,,,,,,,,,,,,,,,,,,,,,
290,Andrew Bogut,1,PF,82,77,2348,323,606,0.533,0,3,0,323,603,0.536,0.533,122,194,0.629,189,384,573,192,49,68,125,259,768
290,Andrew Bogut,2,C,66,66,2258,348,629,0.553,1,5,0.2,347,624,0.556,0.554,112,194,0.577,168,416,584,198,49,35,150,216,809
290,Andrew Bogut,3,C,78,78,2720,465,910,0.511,0,7,0,465,903,0.515,0.511,189,322,0.587,245,518,763,199,64,135,172,254,1119
290,Andrew Bogut,4,C,36,33,1124,183,317,0.577,0,0,,183,317,0.577,0.577,56,98,0.571,117,252,369,72,23,37,86,130,422
291,Marvin Williams,1,PF,79,7,1952,235,531,0.443,13,53,0.245,222,478,0.464,0.455,189,253,0.747,122,261,383,63,48,24,83,227,672
291,Marvin Williams,2,PF,64,63,2179,306,706,0.433,11,45,0.244,295,661,0.446,0.441,216,265,0.815,84,253,337,121,52,30,127,191,839
291,Marvin Williams,3,SF,80,80,2765,424,918,0.462,1,10,0.1,423,908,0.466,0.462,336,409,0.822,119,338,457,137,81,33,127,225,1185
291,Marvin Williams,4,SF,61,59,2093,285,622,0.458,55,155,0.355,230,467,0.493,0.502,220,273,0.806,110,272,382,81,57,39,70,127,845
292,Deron Williams,1,PG,80,47,2307,339,805,0.421,91,219,0.416,248,586,0.423,0.478,95,135,0.704,35,159,194,359,60,17,145,233,864
292,Deron Williams,2,PG,80,80,2950,494,1083,0.456,82,255,0.322,412,828,0.498,0.494,227,296,0.767,41,226,267,745,78,13,246,254,1297
292,Deron Williams,3,PG,82,82,3059,566,1117,0.507,83,210,0.395,483,907,0.533,0.544,330,411,0.803,34,209,243,862,90,23,279,200,1545
292,Deron Williams,4,PG,68,68,2505,463,984,0.471,70,226,0.31,393,758,0.518,0.506,326,384,0.849,24,171,195,725,73,20,228,134,1322
293,Chris Paul,1,PG,78,78,2808,407,947,0.43,50,177,0.282,357,770,0.464,0.456,394,465,0.847,61,339,400,611,175,6,183,218,1258
293,Chris Paul,2,PG,64,64,2353,381,871,0.437,50,143,0.35,331,728,0.455,0.466,292,357,0.818,54,226,280,569,118,3,161,154,1104
293,Chris Paul,3,PG,80,80,3006,630,1291,0.488,92,249,0.369,538,1042,0.516,0.524,332,390,0.851,62,259,321,925,217,4,201,185,1684
293,Chris Paul,4,PG,78,78,3002,631,1255,0.503,64,176,0.364,567,1079,0.525,0.528,455,524,0.868,69,363,432,861,216,10,231,212,1781
294,Raymond Felton,1,PG,80,54,2406,345,883,0.391,97,271,0.358,248,612,0.405,0.446,161,222,0.725,77,188,265,446,102,8,182,181,948
294,Raymond Felton,2,PG,78,75,2832,393,1024,0.384,103,312,0.33,290,712,0.407,0.434,204,256,0.797,51,216,267,545,118,10,230,180,1093
294,Raymond Felton,3,PG,79,79,2972,412,997,0.413,56,200,0.28,356,797,0.447,0.441,260,325,0.8,37,199,236,583,96,12,213,184,1140
294,Raymond Felton,4,PG,82,81,3086,442,1083,0.408,59,207,0.285,383,876,0.437,0.435,219,272,0.805,54,256,310,553,126,30,228,191,1162
295,Martell Webster,1,SF,61,18,1070,139,348,0.399,65,182,0.357,74,166,0.446,0.493,61,71,0.859,29,101,130,34,21,14,43,90,404
295,Martell Webster,2,SF,82,27,1759,195,492,0.396,91,250,0.364,104,242,0.43,0.489,93,132,0.705,43,197,240,52,35,19,76,126,574
295,Martell Webster,3,SF,75,70,2132,277,656,0.422,123,317,0.388,154,339,0.454,0.516,122,166,0.735,54,242,296,90,42,28,83,159,799
295,Martell Webster,4,SF,1,0,5,0,1,0,0,1,0,0,0,,0,0,0,,0,0,0,0,0,0,0,0,0
296,Charlie Villanueva,1,PF,81,36,2361,435,940,0.463,70,214,0.327,365,726,0.503,0.5,113,160,0.706,181,340,521,88,60,63,99,247,1053
296,Charlie Villanueva,2,PF,39,17,984,180,383,0.47,29,86,0.337,151,297,0.508,0.508,73,89,0.82,62,166,228,36,24,12,54,108,462
296,Charlie Villanueva,3,PF,76,31,1829,354,814,0.435,55,185,0.297,299,629,0.475,0.469,123,157,0.783,145,321,466,78,30,35,107,174,886
296,Charlie Villanueva,4,PF,78,47,2095,487,1089,0.447,89,258,0.345,398,831,0.479,0.488,201,240,0.838,154,366,520,137,50,56,138,254,1264
297,Channing Frye,1,C,65,14,1572,305,640,0.477,3,9,0.333,302,631,0.479,0.479,189,229,0.825,138,236,374,53,30,47,97,200,802
297,Channing Frye,2,PF,72,59,1896,298,689,0.433,3,18,0.167,295,671,0.44,0.435,85,108,0.787,91,304,395,67,36,42,100,216,684
297,Channing Frye,3,C,78,20,1342,221,453,0.488,3,10,0.3,218,443,0.492,0.491,85,109,0.78,107,247,354,57,29,27,55,208,530
297,Channing Frye,4,PF,63,1,746,113,267,0.423,11,33,0.333,102,234,0.436,0.444,26,36,0.722,41,99,140,24,17,16,29,106,263
298,Ike Diogu,1,PF,69,14,1031,175,334,0.524,0,0,,175,334,0.524,0.524,136,168,0.81,95,134,229,29,15,30,78,164,486
298,Ike Diogu,2,PF,59,2,760,127,266,0.477,0,0,,127,266,0.477,0.477,112,140,0.8,75,128,203,25,8,26,67,122,366
298,Ike Diogu,3,PF,17,0,222,44,83,0.53,0,0,,44,83,0.53,0.53,35,44,0.795,21,42,63,5,3,11,18,35,123
298,Ike Diogu,4,PF,42,2,538,83,183,0.454,0,0,,83,183,0.454,0.454,77,96,0.802,54,86,140,20,5,15,49,87,243
299,Andrew Bynum,1,C,46,0,338,33,82,0.402,0,0,,33,82,0.402,0.402,8,27,0.296,34,46,80,9,4,22,17,56,74
299,Andrew Bynum,2,C,82,53,1793,247,443,0.558,0,3,0,247,440,0.561,0.558,143,214,0.668,139,345,484,94,12,128,115,249,637
299,Andrew Bynum,3,C,35,25,1008,189,297,0.636,0,0,,189,297,0.636,0.636,82,118,0.695,105,251,356,61,12,72,52,98,460
299,Andrew Bynum,4,C,50,50,1446,281,502,0.56,0,0,,281,502,0.56,0.56,152,215,0.707,137,261,398,71,18,90,85,157,714
300,Fran Vazquez,No NBA Data,,,,,,,,,,,,,,,,,,,,,,,,,,
301,Yaroslav Korolev,1,SF,24,0,127,9,30,0.3,2,7,0.286,7,23,0.304,0.333,7,10,0.7,5,8,13,9,3,0,6,11,27
301,Yaroslav Korolev,2,SF,10,0,41,4,16,0.25,1,5,0.2,3,11,0.273,0.281,3,6,0.5,1,2,3,4,3,0,1,0,12
302,Sean May,1,PF,23,1,398,70,171,0.409,0,5,0,70,166,0.422,0.409,49,64,0.766,42,67,109,22,17,12,33,58,189
302,Sean May,2,PF,35,8,838,164,328,0.5,2,3,0.667,162,325,0.498,0.503,86,112,0.768,73,160,233,66,19,24,56,100,416
302,Sean May,3,PF,24,12,301,39,98,0.398,1,1,1,38,97,0.392,0.403,14,20,0.7,20,49,69,10,5,4,26,32,93
302,Sean May,4,C,37,4,331,51,111,0.459,0,4,0,51,107,0.477,0.459,21,32,0.656,20,50,70,17,12,7,19,46,123
303,Rashad McCants,1,SG,79,12,1362,241,535,0.45,67,180,0.372,174,355,0.49,0.513,78,106,0.736,29,114,143,63,44,22,86,176,627
303,Rashad McCants,2,SG,37,0,554,62,177,0.35,20,75,0.267,42,102,0.412,0.407,40,58,0.69,14,33,47,38,26,7,40,71,184
303,Rashad McCants,3,SG,75,24,2020,428,944,0.453,142,349,0.407,286,595,0.481,0.529,116,155,0.748,50,156,206,162,66,18,172,234,1114
303,Rashad McCants,4,SG,58,3,1101,192,488,0.393,63,189,0.333,129,299,0.431,0.458,107,141,0.759,21,89,110,68,47,14,64,103,554
304,Antoine Wright,1,SG,39,0,370,29,81,0.358,1,15,0.067,28,66,0.424,0.364,11,22,0.5,8,22,30,12,4,3,21,42,70
304,Antoine Wright,2,SG,63,23,1137,110,251,0.438,19,59,0.322,91,192,0.474,0.476,44,73,0.603,38,137,175,55,30,10,43,120,283
304,Antoine Wright,3,SG,56,10,1232,136,329,0.413,32,110,0.291,104,219,0.475,0.462,46,67,0.687,40,107,147,80,28,21,50,127,350
304,Antoine Wright,4,SG,41,10,1056,115,287,0.401,27,101,0.267,88,186,0.473,0.448,41,58,0.707,35,90,125,67,26,17,39,105,298
305,Joey Graham,1,SF,80,24,1581,198,414,0.478,29,87,0.333,169,327,0.517,0.513,108,133,0.812,57,187,244,60,37,13,92,228,533
305,Joey Graham,2,SF,79,21,1319,192,388,0.495,9,31,0.29,183,357,0.513,0.506,110,131,0.84,55,193,248,44,30,4,49,161,503
305,Joey Graham,3,SF,38,3,331,49,113,0.434,2,3,0.667,47,110,0.427,0.442,38,45,0.844,18,49,67,15,3,0,23,47,138
305,Joey Graham,4,SF,78,10,1541,231,480,0.481,3,16,0.188,228,464,0.491,0.484,132,160,0.825,95,197,292,48,35,12,74,191,597
306,Danny Granger,1,SF,78,17,1765,221,478,0.462,30,93,0.323,191,385,0.496,0.494,115,148,0.777,131,253,384,90,58,62,80,211,587
306,Danny Granger,2,SF,82,57,2785,398,868,0.459,110,288,0.382,288,580,0.497,0.522,236,294,0.803,114,267,381,114,67,61,135,245,1142
306,Danny Granger,3,SF,80,80,2876,537,1205,0.446,171,423,0.404,366,782,0.468,0.517,322,378,0.852,93,393,486,166,95,84,171,290,1567
306,Danny Granger,4,SF,67,66,2424,571,1277,0.447,182,450,0.404,389,827,0.47,0.518,404,460,0.878,49,292,341,183,69,97,165,207,1728
307,Gerald Green,1,SG,32,3,374,66,138,0.478,6,20,0.3,60,118,0.508,0.5,29,37,0.784,10,31,41,18,13,4,22,41,167
307,Gerald Green,2,SF,81,26,1780,310,739,0.419,95,258,0.368,215,481,0.447,0.484,128,159,0.805,68,140,208,83,41,24,120,198,843
307,Gerald Green,3,SF,30,0,362,52,151,0.344,15,39,0.385,37,112,0.33,0.394,34,41,0.829,13,51,64,29,8,4,32,45,153
307,Gerald Green,4,SF,29,0,358,49,148,0.331,15,39,0.385,34,109,0.312,0.382,34,41,0.829,11,51,62,29,8,4,32,43,147
308,Hakim Warrick,1,PF,68,2,724,101,228,0.443,0,0,,101,228,0.443,0.443,76,115,0.661,43,101,144,30,14,21,56,113,278
308,Hakim Warrick,2,PF,82,43,2152,373,712,0.524,0,8,0,373,704,0.53,0.524,299,388,0.771,130,290,420,75,43,30,161,232,1045
308,Hakim Warrick,3,PF,75,30,1754,328,653,0.502,13,48,0.271,315,605,0.521,0.512,183,260,0.704,123,233,356,53,36,28,85,156,852
308,Hakim Warrick,4,PF,82,7,2029,340,693,0.491,5,23,0.217,335,670,0.5,0.494,266,374,0.711,129,277,406,66,48,39,98,170,951
309,Julius Hodge,1,SG,14,0,33,5,13,0.385,0,0,,5,13,0.385,0.385,3,8,0.375,5,2,7,6,2,0,8,7,13
309,Julius Hodge,2,SG,9,1,65,6,12,0.5,0,0,,6,12,0.5,0.5,3,4,0.75,2,6,8,12,4,0,3,6,15
309,Julius Hodge,3,SG,4,1,37,2,5,0.4,0,0,,2,5,0.4,0.4,2,2,1,1,2,3,10,3,0,1,3,6
309,Julius Hodge,4,SG,5,0,28,4,7,0.571,0,0,,4,7,0.571,0.571,1,2,0.5,1,4,5,2,1,0,2,3,9
310,Nate Robinson,1,PG,72,26,1544,230,565,0.407,58,146,0.397,172,419,0.411,0.458,152,202,0.752,56,111,167,147,59,1,114,201,670
310,Nate Robinson,2,PG,64,5,1356,227,523,0.434,83,213,0.39,144,310,0.465,0.513,108,139,0.777,55,97,152,90,50,6,72,160,645
310,Nate Robinson,3,PG,72,17,1883,331,782,0.423,97,292,0.332,234,490,0.478,0.485,154,196,0.786,51,171,222,212,60,1,103,186,913
310,Nate Robinson,4,PG,74,11,2209,449,1028,0.437,125,385,0.325,324,643,0.504,0.498,249,296,0.841,98,192,290,301,95,6,139,206,1272
311,Jarrett Jack,1,SG,79,4,1599,189,428,0.442,20,76,0.263,169,352,0.48,0.465,128,160,0.8,18,142,160,219,41,2,102,138,526
311,Jarrett Jack,2,PG,79,79,2651,320,705,0.454,63,180,0.35,257,525,0.49,0.499,243,279,0.871,18,190,208,417,86,9,187,202,946
311,Jarrett Jack,3,SG,82,16,2229,267,620,0.431,65,190,0.342,202,430,0.47,0.483,215,248,0.867,31,203,234,313,61,1,178,129,814
311,Jarrett Jack,4,SG,82,53,2716,386,853,0.453,78,221,0.353,308,632,0.487,0.498,224,263,0.852,44,232,276,338,88,17,184,179,1074
312,Francisco Garcia,1,SF,67,11,1301,130,325,0.4,39,137,0.285,91,188,0.484,0.46,78,101,0.772,39,146,185,94,41,47,75,135,377
312,Francisco Garcia,2,SF,79,5,1410,163,380,0.429,53,149,0.356,110,231,0.476,0.499,95,114,0.833,53,152,205,87,45,43,70,190,474
312,Francisco Garcia,3,SF,79,20,2096,348,752,0.463,113,289,0.391,235,463,0.508,0.538,162,208,0.779,52,212,264,128,96,50,128,232,971
312,Francisco Garcia,4,SF,65,36,1975,295,665,0.444,88,221,0.398,207,444,0.466,0.51,146,178,0.82,56,162,218,150,80,67,112,196,824
313,Luther Head,1,SG,80,27,2310,254,630,0.403,113,313,0.361,141,317,0.445,0.493,86,123,0.699,33,233,266,215,89,9,119,169,707
313,Luther Head,2,SG,80,10,2211,306,700,0.437,177,401,0.441,129,299,0.431,0.564,83,105,0.79,31,221,252,194,76,5,137,133,872
313,Luther Head,3,SG,73,17,1379,206,477,0.432,79,225,0.351,127,252,0.504,0.515,66,81,0.815,18,117,135,138,44,9,70,75,557
313,Luther Head,4,PG-SG,32,4,498,55,144,0.382,20,54,0.37,35,90,0.389,0.451,19,24,0.792,6,46,52,58,17,2,25,37,149
314,Johan Petro,1,C,68,41,1282,153,300,0.51,0,0,,153,300,0.51,0.51,47,75,0.627,109,187,296,15,25,51,60,213,353
314,Johan Petro,2,C,81,13,1510,226,438,0.516,0,0,,226,438,0.516,0.516,50,77,0.649,92,243,335,45,39,47,82,237,502
314,Johan Petro,3,C,72,28,1310,184,439,0.419,0,1,0,184,438,0.42,0.419,64,87,0.736,98,272,370,32,35,42,73,173,432
314,Johan Petro,4,C,49,22,559,73,176,0.415,0,2,0,73,174,0.42,0.415,16,29,0.552,42,116,158,16,19,15,28,107,162
315,Jason Maxiell,1,PF,26,0,159,23,54,0.426,0,0,,23,54,0.426,0.426,14,42,0.333,12,16,28,3,4,5,11,14,60
315,Jason Maxiell,2,C,67,8,943,131,262,0.5,0,0,,131,262,0.5,0.5,72,137,0.526,88,98,186,14,30,60,53,110,334
315,Jason Maxiell,3,C,82,7,1768,240,446,0.538,0,1,0,240,445,0.539,0.538,171,270,0.633,177,256,433,46,21,94,71,183,651
315,Jason Maxiell,4,C,78,4,1408,184,320,0.575,0,1,0,184,319,0.577,0.575,84,158,0.532,169,155,324,24,25,63,45,157,452
316,Linas Kleiza,1,PF,61,2,519,77,173,0.445,2,13,0.154,75,160,0.469,0.451,57,81,0.704,38,78,116,15,10,13,16,87,213
316,Linas Kleiza,2,PF,79,14,1488,200,474,0.422,83,221,0.376,117,253,0.462,0.509,115,135,0.852,77,189,266,45,28,14,79,200,598
316,Linas Kleiza,3,SF,79,13,1889,311,659,0.472,94,277,0.339,217,382,0.568,0.543,164,213,0.77,92,241,333,95,44,19,89,181,880
316,Linas Kleiza,4,SF,82,7,1824,289,646,0.447,87,267,0.326,202,379,0.533,0.515,148,204,0.725,92,235,327,64,31,14,82,155,813
317,Ian Mahinmi,1,C,6,0,23,6,12,0.5,0,0,,6,12,0.5,0.5,9,9,1,0,5,5,1,0,4,2,4,21
317,Ian Mahinmi,2,C,26,0,165,35,55,0.636,0,0,,35,55,0.636,0.636,31,47,0.66,13,39,52,2,3,8,15,32,101
317,Ian Mahinmi,3,C,56,0,488,55,98,0.561,0,2,0,55,96,0.573,0.561,63,82,0.768,43,77,120,8,14,15,25,105,173
317,Ian Mahinmi,4,C,61,12,1139,130,238,0.546,0,1,0,130,237,0.549,0.546,94,147,0.639,108,181,289,12,38,31,50,176,354
318,Wayne Simien,1,PF,43,2,414,58,120,0.483,0,0,,58,120,0.483,0.483,30,34,0.882,38,50,88,7,13,1,24,70,146
318,Wayne Simien,2,PF,8,0,93,9,23,0.391,0,0,,9,23,0.391,0.391,5,7,0.714,5,6,11,4,2,0,3,13,23
319,David Lee,1,SF,67,14,1129,137,230,0.596,0,0,,137,230,0.596,0.596,71,123,0.577,109,194,303,43,30,20,51,124,345
319,David Lee,2,PF,58,12,1731,240,400,0.6,0,0,,240,400,0.6,0.6,141,173,0.815,196,406,602,104,48,23,92,155,621
319,David Lee,3,PF,81,29,2356,341,618,0.552,0,2,0,341,616,0.554,0.552,194,237,0.819,242,482,724,95,55,29,97,210,876
319,David Lee,4,C,81,74,2824,522,951,0.549,0,3,0,522,948,0.551,0.549,249,330,0.755,256,695,951,174,80,22,150,260,1293
320,Salim Stoudamire,1,SG,61,1,1236,204,492,0.415,82,216,0.38,122,276,0.442,0.498,99,110,0.9,12,104,116,75,27,3,82,118,589
320,Salim Stoudamire,2,SG,61,0,1034,177,425,0.416,56,155,0.361,121,270,0.448,0.482,61,68,0.897,6,68,74,61,21,2,55,88,471
320,Salim Stoudamire,3,PG,35,0,402,65,180,0.361,29,85,0.341,36,95,0.379,0.442,41,50,0.82,4,20,24,28,7,5,21,34,200
321,Daniel Ewing,1,SG,66,5,971,97,255,0.38,22,78,0.282,75,177,0.424,0.424,36,46,0.783,23,62,85,84,37,6,57,86,252
321,Daniel Ewing,2,PG,61,3,712,65,161,0.404,14,44,0.318,51,117,0.436,0.447,35,45,0.778,9,64,73,90,32,4,50,62,179
322,Brandon Bass,1,PF,29,1,268,28,70,0.4,0,0,,28,70,0.4,0.4,12,19,0.632,18,50,68,3,3,7,11,18,68
322,Brandon Bass,2,PF,21,3,162,15,44,0.341,0,1,0,15,43,0.349,0.341,12,16,0.75,13,30,43,3,2,3,10,16,42
322,Brandon Bass,3,C,79,1,1557,246,493,0.499,0,4,0,246,489,0.503,0.499,162,197,0.822,120,227,347,58,22,48,82,150,654
322,Brandon Bass,4,C,81,0,1574,252,508,0.496,0,6,0,252,502,0.502,0.496,182,210,0.867,129,238,367,43,27,55,86,140,686
323,C.J. Miles,1,PG,23,0,203,28,76,0.368,5,20,0.25,23,56,0.411,0.401,18,24,0.75,18,20,38,16,7,2,9,20,79
323,C.J. Miles,2,SG,37,13,373,40,116,0.345,7,32,0.219,33,84,0.393,0.375,14,23,0.609,11,24,35,25,11,4,28,60,101
323,C.J. Miles,3,SG,60,13,689,113,236,0.479,30,77,0.39,83,159,0.522,0.542,41,52,0.788,16,62,78,53,32,8,27,98,297
323,C.J. Miles,4,SG,72,72,1623,258,562,0.459,63,179,0.352,195,383,0.509,0.515,78,89,0.876,45,122,167,107,46,15,64,187,657
324,Ricky Sanchez,No NBA Data,,,,,,,,,,,,,,,,,,,,,,,,,,
325,Ersan Ilyasova,1,PF,66,14,973,139,363,0.383,54,148,0.365,85,215,0.395,0.457,70,89,0.787,58,131,189,49,27,17,51,147,402
325,Ersan Ilyasova,2,PF,81,31,1898,323,729,0.443,81,241,0.336,242,488,0.496,0.499,113,158,0.715,157,360,517,84,53,23,71,251,840
325,Ersan Ilyasova,3,PF,60,34,1505,221,507,0.436,36,121,0.298,185,386,0.479,0.471,93,104,0.894,105,260,365,56,51,24,63,159,571
325,Ersan Ilyasova,4,PF,60,41,1655,294,597,0.492,51,112,0.455,243,485,0.501,0.535,143,183,0.781,196,333,529,71,42,44,76,133,782
326,Ronny Turiaf,1,C,23,1,161,15,30,0.5,0,0,,15,30,0.5,0.5,15,27,0.556,11,26,37,8,3,10,7,30,45
326,Ronny Turiaf,2,C,72,1,1087,147,268,0.549,0,1,0,147,267,0.551,0.549,89,134,0.664,88,171,259,63,17,78,52,202,383
326,Ronny Turiaf,3,C,78,21,1458,188,397,0.474,0,1,0,188,396,0.475,0.474,140,186,0.753,95,211,306,128,28,108,72,199,516
326,Ronny Turiaf,4,C,79,26,1696,186,366,0.508,0,3,0,186,363,0.512,0.508,98,124,0.79,88,272,360,166,34,168,70,243,470
327,Travis Diener,1,PG,23,0,246,29,69,0.42,25,57,0.439,4,12,0.333,0.601,5,6,0.833,4,17,21,16,7,0,10,22,88
327,Travis Diener,2,PG,26,0,288,34,80,0.425,18,50,0.36,16,30,0.533,0.538,12,15,0.8,3,15,18,35,4,0,13,27,98
327,Travis Diener,3,PG,66,21,1356,159,430,0.37,74,233,0.318,85,197,0.431,0.456,64,71,0.901,26,89,115,251,35,4,55,107,456
327,Travis Diener,4,PG,55,0,719,74,179,0.413,46,118,0.39,28,61,0.459,0.542,12,15,0.8,6,80,86,122,26,5,21,42,206
328,Von Wafer,1,SG,16,0,73,6,38,0.158,2,17,0.118,4,21,0.19,0.184,6,8,0.75,5,3,8,4,3,0,1,12,20
328,Von Wafer,2,SF,1,0,1,0,1,0,0,1,0,0,0,,0,0,0,,0,0,0,0,0,0,0,0,0
328,Von Wafer,3,SG,29,0,154,17,61,0.279,4,26,0.154,13,35,0.371,0.311,8,12,0.667,1,18,19,7,2,3,13,7,46
328,Von Wafer,4,SG,21,0,90,10,38,0.263,1,15,0.067,9,23,0.391,0.276,6,8,0.75,1,9,10,5,2,1,11,4,27
329,Monta Ellis,1,SG,49,3,886,132,318,0.415,28,82,0.341,104,236,0.441,0.459,42,59,0.712,22,83,105,78,32,11,58,69,334
329,Monta Ellis,2,SG,77,53,2638,480,1010,0.475,39,143,0.273,441,867,0.509,0.495,273,358,0.763,62,181,243,319,132,21,221,210,1272
329,Monta Ellis,3,SG,81,72,3071,652,1227,0.531,12,52,0.231,640,1175,0.545,0.536,320,417,0.767,133,271,404,315,124,27,173,195,1636
329,Monta Ellis,4,SG,25,25,892,194,430,0.451,8,26,0.308,186,404,0.46,0.46,78,94,0.83,14,94,108,93,39,8,67,67,474
330,Roko Ukic,1,PG,72,0,890,123,324,0.38,11,62,0.177,112,262,0.427,0.397,44,60,0.733,27,48,75,153,30,2,60,77,301
330,Roko Ukic,2,PG,13,0,97,14,30,0.467,3,12,0.25,11,18,0.611,0.517,9,11,0.818,0,3,3,12,1,0,6,6,40
331,Chris Taft,1,C,17,0,144,23,38,0.605,0,0,,23,38,0.605,0.605,1,6,0.167,19,17,36,2,2,7,2,25,47
332,Mile Ilic,1,C,5,0,6,0,3,0,0,0,,0,3,0,0,0,0,,0,1,1,0,0,0,3,1,0
333,Martynas Andriuskevicius,1,C,6,0,9,0,1,0,0,0,,0,1,0,0,0,0,,1,3,4,0,2,0,0,1,0
334,Louis Williams,1,PG,30,0,145,23,52,0.442,2,9,0.222,21,43,0.488,0.462,8,13,0.615,3,16,19,10,5,0,13,13,56
334,Louis Williams,2,PG,61,0,688,93,211,0.441,12,37,0.324,81,174,0.466,0.469,64,92,0.696,17,53,70,110,22,1,46,42,262
334,Louis Williams,3,PG,80,0,1862,319,752,0.424,55,153,0.359,264,599,0.441,0.461,227,290,0.783,41,126,167,253,81,13,125,130,920
334,Louis Williams,4,SG,81,0,1919,336,844,0.398,63,220,0.286,273,624,0.438,0.435,304,385,0.79,36,129,165,242,85,14,151,128,1039
335,Erazem Lorbek,No NBA Data,,,,,,,,,,,,,,,,,,,,,,,,,,
336,Bracey Wright,1,SG,7,0,135,21,51,0.412,6,17,0.353,15,34,0.441,0.471,14,16,0.875,3,15,18,5,1,0,8,8,62
336,Bracey Wright,2,SG,19,0,190,24,60,0.4,6,20,0.3,18,40,0.45,0.45,13,18,0.722,7,14,21,15,9,1,6,6,67
337,Mickael Gelabale,1,SF,70,14,1239,122,264,0.462,11,47,0.234,111,217,0.512,0.483,66,82,0.805,59,114,173,56,24,22,49,108,321
337,Mickael Gelabale,2,SG,39,0,465,69,157,0.439,16,37,0.432,53,120,0.442,0.49,14,18,0.778,16,42,58,33,10,9,27,31,168
337,Mickael Gelabale,3,SF,36,13,644,72,139,0.518,16,52,0.308,56,87,0.644,0.576,21,24,0.875,32,67,99,26,16,4,16,47,181
338,Andray Blatche,1,PF,29,0,175,26,67,0.388,3,13,0.231,23,54,0.426,0.41,10,12,0.833,12,26,38,10,5,7,12,36,65
338,Andray Blatche,2,PF,56,13,682,86,197,0.437,4,27,0.148,82,170,0.482,0.447,30,49,0.612,77,114,191,39,17,32,49,94,206
338,Andray Blatche,3,PF,82,15,1675,254,536,0.474,3,13,0.231,251,523,0.48,0.477,107,154,0.695,164,261,425,92,53,114,112,258,618
338,Andray Blatche,4,C,71,36,1703,297,630,0.471,5,21,0.238,292,609,0.479,0.475,114,162,0.704,126,252,378,118,53,74,117,211,713
339,Ryan Gomes,1,PF,61,33,1376,173,355,0.487,3,9,0.333,170,346,0.491,0.492,112,149,0.752,102,196,298,58,35,5,55,83,461
339,Ryan Gomes,2,PF,73,60,2275,338,723,0.467,16,42,0.381,322,681,0.473,0.479,189,233,0.811,125,282,407,119,48,13,105,169,881
339,Ryan Gomes,3,PF,82,74,2434,392,857,0.457,59,179,0.33,333,678,0.491,0.492,190,229,0.83,133,342,475,145,65,10,96,154,1033
339,Ryan Gomes,4,SF,82,76,2614,420,974,0.431,106,285,0.372,314,689,0.456,0.486,146,181,0.807,106,286,392,135,63,22,128,183,1092
340,Robert Whaley,1,C,23,0,212,23,57,0.404,0,0,,23,57,0.404,0.404,3,6,0.5,16,27,43,17,7,8,14,41,49
341,Axel Hervelle,No NBA Data,,,,,,,,,,,,,,,,,,,,,,,,,,
342,Orien Greene,1,PG,80,5,1235,100,253,0.395,9,40,0.225,91,213,0.427,0.413,45,68,0.662,37,108,145,129,77,10,109,181,254
342,Orien Greene,2,SG,41,0,254,23,62,0.371,2,11,0.182,21,51,0.412,0.387,15,25,0.6,12,32,44,22,17,4,28,38,63
342,Orien Greene,3,SG,7,2,61,3,11,0.273,0,1,0,3,10,0.3,0.273,0,0,,0,6,6,3,3,1,7,9,6
342,Orien Greene,4,SG,3,0,5,1,2,0.5,0,0,,1,2,0.5,0.5,1,2,0.5,0,0,0,1,1,0,0,0,3
343,Dijon Thompson,1,SG,10,0,43,11,25,0.44,4,11,0.364,7,14,0.5,0.52,2,2,1,4,7,11,1,3,1,2,6,28
343,Dijon Thompson,2,SF,6,0,50,6,15,0.4,0,2,0,6,13,0.462,0.4,5,6,0.833,3,5,8,2,0,0,1,2,17
344,Lawrence Roberts,1,C,33,0,181,20,44,0.455,0,2,0,20,42,0.476,0.455,11,23,0.478,26,23,49,5,8,2,5,30,51
344,Lawrence Roberts,2,PF,54,18,969,94,208,0.452,0,2,0,94,206,0.456,0.452,95,131,0.725,101,160,261,30,36,13,36,133,283
345,Amir Johnson,1,SF,3,0,39,7,10,0.7,2,3,0.667,5,7,0.714,0.8,4,4,1,3,1,4,3,0,2,4,7,20
345,Amir Johnson,2,PF,8,0,124,18,33,0.545,0,3,0,18,30,0.6,0.545,11,14,0.786,15,22,37,3,5,13,9,19,47
345,Amir Johnson,3,PF,62,0,764,92,165,0.558,0,0,,92,165,0.558,0.558,37,55,0.673,87,148,235,29,24,82,39,141,221
345,Amir Johnson,4,PF,62,24,911,97,163,0.595,0,0,,97,163,0.595,0.595,23,35,0.657,102,130,232,20,20,60,33,171,217
346,Marcin Gortat,1,C,6,0,41,8,17,0.471,0,0,,8,17,0.471,0.471,2,3,0.667,8,8,16,2,1,1,2,4,18
346,Marcin Gortat,2,PF,63,3,794,106,187,0.567,1,1,1,105,186,0.565,0.57,26,45,0.578,96,190,286,14,18,53,25,111,239
346,Marcin Gortat,3,C,81,0,1088,121,227,0.533,0,3,0,121,224,0.54,0.533,51,75,0.68,104,237,341,17,17,70,46,138,293
346,Marcin Gortat,4,C,80,14,2032,338,603,0.561,1,4,0.25,337,599,0.563,0.561,140,193,0.725,148,483,631,70,36,91,81,188,817
347,Uros Slokar,1,C,20,0,72,14,26,0.538,1,2,0.5,13,24,0.542,0.558,9,13,0.692,7,7,14,1,1,2,9,11,38
348,Cenk Akyol,No NBA Data,,,,,,,,,,,,,,,,,,,,,,,,,,
349,Alex Acker,1,SG,5,0,35,4,16,0.25,1,5,0.2,3,11,0.273,0.281,0,0,,1,4,5,4,1,0,4,4,9
349,Alex Acker,2,SG,25,0,199,30,76,0.395,7,20,0.35,23,56,0.411,0.441,5,10,0.5,8,16,24,12,5,4,7,9,72
349,Alex Acker,3,SG,7,0,20,4,11,0.364,0,4,0,4,7,0.571,0.364,1,2,0.5,0,2,2,1,2,1,0,0,9
349,Alex Acker,4,SG,18,0,179,26,65,0.4,7,16,0.438,19,49,0.388,0.454,4,8,0.5,8,14,22,11,3,3,7,9,63
350,Andrea Bargnani,1,PF,65,2,1629,267,625,0.427,100,268,0.373,167,357,0.468,0.507,117,142,0.824,52,203,255,50,32,53,107,180,751
350,Andrea Bargnani,2,PF,78,53,1861,280,725,0.386,90,261,0.345,190,464,0.409,0.448,142,169,0.84,50,238,288,89,23,37,88,211,792
350,Andrea Bargnani,3,PF,78,59,2453,431,958,0.45,119,291,0.409,312,667,0.468,0.512,221,266,0.831,70,346,416,94,34,97,135,242,1202
350,Andrea Bargnani,4,PF,80,80,2799,537,1143,0.47,121,325,0.372,416,818,0.509,0.523,181,234,0.774,105,388,493,93,25,111,120,215,1376
351,LaMarcus Aldridge,1,C,63,22,1392,241,479,0.503,0,2,0,241,477,0.505,0.503,83,115,0.722,144,168,312,24,22,73,43,186,565
351,LaMarcus Aldridge,2,PF,76,76,2649,561,1160,0.484,1,7,0.143,560,1153,0.486,0.484,227,298,0.762,220,358,578,122,55,94,126,240,1350
351,LaMarcus Aldridge,3,PF,81,81,3004,601,1243,0.484,7,28,0.25,594,1215,0.489,0.486,261,334,0.781,234,371,605,157,77,77,121,207,1470
351,LaMarcus Aldridge,4,PF,78,78,2922,579,1169,0.495,5,16,0.313,574,1153,0.498,0.497,230,304,0.757,192,435,627,160,67,48,104,231,1393
352,Adam Morrison,1,PF,78,23,2326,355,944,0.376,87,258,0.337,268,686,0.391,0.422,120,169,0.71,54,176,230,163,28,6,130,179,917
352,Adam Morrison,2,SF,52,5,711,80,223,0.359,32,96,0.333,48,127,0.378,0.43,17,23,0.739,18,62,80,41,9,4,32,77,209
352,Adam Morrison,3,SF,44,5,667,76,211,0.36,31,92,0.337,45,119,0.378,0.434,16,21,0.762,16,56,72,38,9,4,29,73,199
352,Adam Morrison,4,SF,8,0,44,4,12,0.333,1,4,0.25,3,8,0.375,0.375,1,2,0.5,2,6,8,3,0,0,3,4,10
353,Tyrus Thomas,1,PF,72,4,966,134,282,0.475,0,2,0,134,280,0.479,0.475,106,175,0.606,89,180,269,40,46,76,94,162,374
353,Tyrus Thomas,2,PF,74,27,1330,186,440,0.423,1,6,0.167,185,434,0.426,0.424,129,174,0.741,102,240,342,90,48,72,77,170,502
353,Tyrus Thomas,3,PF,79,61,2175,308,683,0.451,3,9,0.333,305,674,0.453,0.453,238,304,0.783,148,360,508,77,91,151,129,220,857
353,Tyrus Thomas,4,PF-C,54,3,1220,194,420,0.462,0,3,0,194,417,0.465,0.462,120,175,0.686,81,254,335,56,63,85,92,129,508
354,Shelden Williams,1,PF,81,31,1514,166,365,0.455,2,4,0.5,164,361,0.454,0.458,110,144,0.764,131,304,435,44,52,39,96,199,444
354,Shelden Williams,2,PF,64,0,776,92,212,0.434,0,2,0,92,210,0.438,0.434,71,105,0.676,68,137,205,19,22,21,35,110,255
354,Shelden Williams,3,PF,36,0,414,37,100,0.37,0,1,0,37,99,0.374,0.37,35,51,0.686,34,73,107,11,13,11,14,60,109
354,Shelden Williams,4,PF,28,0,362,55,112,0.491,0,1,0,55,111,0.495,0.491,36,54,0.667,34,64,98,8,9,10,21,50,146
355,Brandon Roy,1,SG,57,55,2015,349,765,0.456,55,146,0.377,294,619,0.475,0.492,202,241,0.838,58,192,250,230,67,10,116,139,955
355,Brandon Roy,2,SG,74,74,2792,531,1170,0.454,73,215,0.34,458,955,0.48,0.485,281,373,0.753,81,267,348,430,79,16,136,147,1416
355,Brandon Roy,3,SG,78,78,2903,633,1318,0.48,83,220,0.377,550,1098,0.501,0.512,416,505,0.824,104,266,370,400,88,22,152,127,1765
355,Brandon Roy,4,SG,65,65,2419,491,1038,0.473,73,221,0.33,418,817,0.512,0.508,343,440,0.78,73,212,285,305,61,16,129,136,1398
356,Randy Foye,1,PG,82,12,1879,300,691,0.434,68,185,0.368,232,506,0.458,0.483,164,192,0.854,49,169,218,232,53,21,152,184,832
356,Randy Foye,2,PG,39,31,1259,198,462,0.429,61,148,0.412,137,314,0.436,0.495,53,65,0.815,13,115,128,164,36,3,79,102,510
356,Randy Foye,3,SG,70,61,2494,399,981,0.407,111,308,0.36,288,673,0.428,0.463,230,272,0.846,34,180,214,303,72,26,150,201,1139
356,Randy Foye,4,PG,70,38,1667,256,619,0.414,63,182,0.346,193,437,0.442,0.464,129,145,0.89,16,114,130,228,33,10,94,123,704
357,Rudy Gay,1,SF,78,43,2103,321,760,0.422,52,143,0.364,269,617,0.436,0.457,152,209,0.727,93,255,348,100,71,74,140,192,846
357,Rudy Gay,2,SF,81,81,3000,625,1355,0.461,134,387,0.346,491,968,0.507,0.511,248,316,0.785,140,359,499,158,111,79,190,230,1632
357,Rudy Gay,3,SF,79,78,2945,572,1262,0.453,85,242,0.351,487,1020,0.477,0.487,264,344,0.767,109,328,437,135,98,59,203,221,1493
357,Rudy Gay,4,SF,80,80,3175,600,1288,0.466,66,202,0.327,534,1086,0.492,0.491,301,400,0.753,115,357,472,153,118,64,169,201,1567
358,Patrick O'Bryant,1,C,16,0,119,10,32,0.313,0,0,,10,32,0.313,0.313,11,17,0.647,7,14,21,9,6,8,8,26,31
358,Patrick O'Bryant,2,C,24,0,99,16,29,0.552,0,0,,16,29,0.552,0.552,3,5,0.6,10,19,29,4,4,9,7,27,35
358,Patrick O'Bryant,3,C,39,3,255,45,84,0.536,0,2,0,45,82,0.549,0.536,11,20,0.55,13,53,66,11,6,19,22,61,101
358,Patrick O'Bryant,4,C,26,0,108,16,31,0.516,0,0,,16,31,0.516,0.516,8,12,0.667,7,27,34,8,3,8,17,29,40
359,Mouhamed Sene,1,C,28,3,169,18,49,0.367,0,0,,18,49,0.367,0.367,17,29,0.586,16,29,45,0,3,12,11,33,53
359,Mouhamed Sene,2,C,13,0,62,11,24,0.458,0,0,,11,24,0.458,0.458,8,17,0.471,7,9,16,1,0,7,0,9,30
359,Mouhamed Sene,3,C,6,0,29,6,9,0.667,0,0,,6,9,0.667,0.667,8,10,0.8,5,9,14,0,1,3,4,2,20
359,Mouhamed Sene,4,C,5,0,23,5,7,0.714,0,0,,5,7,0.714,0.714,7,9,0.778,3,6,9,0,1,2,3,2,17
360,J.J. Redick,1,PG,42,0,622,80,195,0.41,38,98,0.388,42,97,0.433,0.508,54,60,0.9,10,42,52,36,12,0,21,52,252
360,J.J. Redick,2,SG,34,0,276,48,108,0.444,17,43,0.395,31,65,0.477,0.523,27,34,0.794,1,22,23,16,4,0,15,29,140
360,J.J. Redick,3,SG,64,5,1111,117,299,0.391,67,179,0.374,50,120,0.417,0.503,81,93,0.871,8,101,109,73,21,1,54,72,382
360,J.J. Redick,4,SG,82,9,1808,243,553,0.439,111,274,0.405,132,279,0.473,0.54,191,222,0.86,17,138,155,158,28,4,63,118,788
361,Hilton Armstrong,1,C,56,5,634,68,125,0.544,0,0,,68,125,0.544,0.544,40,67,0.597,58,91,149,10,12,26,35,79,176
361,Hilton Armstrong,2,C,65,3,732,67,148,0.453,0,0,,67,148,0.453,0.453,44,70,0.629,65,98,163,23,15,34,59,130,178
361,Hilton Armstrong,3,C,70,29,1092,138,246,0.561,0,2,0,138,244,0.566,0.561,62,98,0.633,81,114,195,29,26,45,80,181,338
361,Hilton Armstrong,4,PF-C,33,0,335,28,79,0.354,0,1,0,28,78,0.359,0.354,15,32,0.469,27,54,81,21,15,12,22,59,71
362,Thabo Sefolosha,1,SG,71,4,868,109,256,0.426,15,42,0.357,94,214,0.439,0.455,23,45,0.511,35,118,153,60,33,11,60,100,256
362,Thabo Sefolosha,2,SG,69,22,1436,180,421,0.428,29,88,0.33,151,333,0.453,0.462,75,104,0.721,50,205,255,129,61,30,93,128,464
362,Thabo Sefolosha,3,SF-SG,66,36,1453,152,357,0.426,24,87,0.276,128,270,0.474,0.459,61,73,0.836,54,188,242,111,75,45,64,104,389
362,Thabo Sefolosha,4,SF,43,14,735,79,182,0.434,15,50,0.3,64,132,0.485,0.475,21,25,0.84,26,97,123,65,35,19,37,50,194
363,Ronnie Brewer,1,SG,56,14,675,102,193,0.528,0,9,0,102,184,0.554,0.528,56,83,0.675,37,38,75,24,37,6,24,44,260
363,Ronnie Brewer,2,SG,76,76,2088,354,634,0.558,11,50,0.22,343,584,0.587,0.567,195,257,0.759,97,121,218,134,129,19,69,110,914
363,Ronnie Brewer,3,SF,81,80,2605,421,828,0.508,22,85,0.259,399,743,0.537,0.522,247,352,0.702,101,199,300,179,138,30,110,128,1111
363,Ronnie Brewer,4,SG,58,53,1742,209,429,0.487,8,31,0.258,201,398,0.505,0.497,85,133,0.639,45,142,187,154,91,15,53,80,511
364,Cedric Simmons,1,PF,43,4,534,55,132,0.417,0,0,,55,132,0.417,0.417,16,33,0.485,44,63,107,12,8,23,22,75,126
364,Cedric Simmons,2,PF,14,0,87,4,14,0.286,0,0,,4,14,0.286,0.286,0,10,0,6,12,18,0,2,5,6,8,8
364,Cedric Simmons,3,PF,7,0,68,2,6,0.333,0,0,,2,6,0.333,0.333,0,8,0,5,10,15,0,2,5,4,7,4
364,Cedric Simmons,4,PF,7,0,19,2,8,0.25,0,0,,2,8,0.25,0.25,0,2,0,1,2,3,0,0,0,2,1,4
365,Rodney Carney,1,SF,67,35,1169,182,392,0.464,25,72,0.347,157,320,0.491,0.496,53,87,0.609,39,89,128,26,38,23,43,118,442
365,Rodney Carney,2,SF,70,6,1039,158,392,0.403,38,120,0.317,120,272,0.441,0.452,55,81,0.679,50,99,149,32,39,23,34,96,409
365,Rodney Carney,3,SG,67,6,1199,176,423,0.416,79,226,0.35,97,197,0.492,0.509,50,66,0.758,36,90,126,26,45,29,43,94,481
365,Rodney Carney,4,SG,68,0,857,113,282,0.401,41,135,0.304,72,147,0.49,0.473,52,63,0.825,26,111,137,37,25,20,21,79,319
366,Shawne Williams,1,SG,46,3,556,75,160,0.469,19,52,0.365,56,108,0.519,0.528,11,20,0.55,33,50,83,22,6,8,24,69,180
366,Shawne Williams,2,SF,65,3,967,159,372,0.427,43,137,0.314,116,235,0.494,0.485,76,106,0.717,54,122,176,59,26,26,58,132,437
366,Shawne Williams,3,SF,15,0,170,16,56,0.286,1,17,0.059,15,39,0.385,0.295,9,11,0.818,19,27,46,2,2,9,5,19,42
366,Shawne Williams,4,PF,64,11,1323,164,385,0.426,85,212,0.401,79,173,0.457,0.536,41,49,0.837,60,179,239,47,39,51,46,164,454
367,Oleksiy Pecherov,1,C,35,0,320,44,125,0.352,17,60,0.283,27,65,0.415,0.42,20,31,0.645,21,45,66,7,6,5,17,30,125
367,Oleksiy Pecherov,2,C,32,0,277,39,101,0.386,14,43,0.326,25,58,0.431,0.455,24,29,0.828,35,41,76,2,6,3,10,34,116
367,Oleksiy Pecherov,3,C,44,5,447,77,188,0.41,14,52,0.269,63,136,0.463,0.447,29,32,0.906,32,92,124,11,9,14,32,55,197
368,Quincy Douby,1,PG,42,0,359,48,126,0.381,12,50,0.24,36,76,0.474,0.429,11,15,0.733,11,26,37,15,15,4,15,21,119
368,Quincy Douby,2,PG,74,0,876,132,335,0.394,42,122,0.344,90,213,0.423,0.457,48,52,0.923,17,66,83,53,30,12,59,80,354
368,Quincy Douby,3,PG,27,0,300,42,110,0.382,14,46,0.304,28,64,0.438,0.445,17,19,0.895,6,26,32,25,5,5,13,27,115
368,Quincy Douby,4,PG,20,0,227,30,88,0.341,10,37,0.27,20,51,0.392,0.398,14,15,0.933,3,22,25,13,2,5,6,23,84
369,Renaldo Balkman,1,SF,68,1,1064,139,275,0.505,5,27,0.185,134,248,0.54,0.515,51,90,0.567,97,197,294,44,57,44,49,146,334
369,Renaldo Balkman,2,SF,65,0,952,91,186,0.489,1,12,0.083,90,174,0.517,0.492,41,95,0.432,83,133,216,40,44,30,37,132,224
369,Renaldo Balkman,3,PF,53,10,780,110,197,0.558,2,7,0.286,108,190,0.568,0.563,42,65,0.646,86,117,203,34,47,23,35,98,264
369,Renaldo Balkman,4,SF,13,1,91,6,18,0.333,0,7,0,6,11,0.545,0.333,2,6,0.333,4,19,23,7,8,2,6,16,14
370,Rajon Rondo,1,PG,78,25,1831,188,450,0.418,6,29,0.207,182,421,0.432,0.424,119,184,0.647,74,218,292,297,128,8,137,181,501
370,Rajon Rondo,2,PG,77,77,2306,351,713,0.492,5,19,0.263,346,694,0.499,0.496,107,175,0.611,78,244,322,393,129,13,147,187,814
370,Rajon Rondo,3,PG,80,80,2642,383,759,0.505,15,48,0.313,368,711,0.518,0.514,172,268,0.642,100,316,416,659,149,11,209,193,953
370,Rajon Rondo,4,PG,81,81,2963,459,904,0.508,17,80,0.213,442,824,0.536,0.517,175,282,0.621,100,260,360,794,189,11,246,198,1110
371,Marcus Williams,1,PG,79,2,1315,208,526,0.395,46,163,0.282,162,363,0.446,0.439,72,85,0.847,29,134,163,260,29,2,142,96,534
371,Marcus Williams,2,PG,53,7,854,111,293,0.379,54,142,0.38,57,151,0.377,0.471,37,47,0.787,14,87,101,140,25,3,75,52,313
371,Marcus Williams,3,PG,9,0,54,4,17,0.235,2,6,0.333,2,11,0.182,0.294,2,6,0.333,0,4,4,13,1,1,4,6,12
371,Marcus Williams,4,PG,62,1,872,104,271,0.384,24,81,0.296,80,190,0.421,0.428,37,55,0.673,13,80,93,161,32,1,74,43,269
372,Josh Boone,1,PF,61,0,669,99,171,0.579,0,0,,99,171,0.579,0.579,56,103,0.544,64,112,176,10,11,21,33,94,254
372,Josh Boone,2,PF,70,53,1773,238,434,0.548,0,0,,238,434,0.548,0.548,99,217,0.456,192,317,509,55,36,61,68,155,575
372,Josh Boone,3,C,62,7,995,113,214,0.528,0,0,,113,214,0.528,0.528,32,85,0.376,104,154,258,31,22,48,31,106,258
372,Josh Boone,4,PF,63,28,1045,117,223,0.525,0,0,,117,223,0.525,0.525,19,58,0.328,124,191,315,29,30,48,37,111,253
373,Kyle Lowry,1,PG,10,0,175,14,38,0.368,3,8,0.375,11,30,0.367,0.408,25,28,0.893,12,19,31,32,14,1,12,20,56
373,Kyle Lowry,2,PG,82,9,2089,256,592,0.432,36,140,0.257,220,452,0.487,0.463,243,348,0.698,41,209,250,296,92,22,127,185,791
373,Kyle Lowry,3,PG,77,21,1679,189,434,0.435,25,98,0.255,164,336,0.488,0.464,181,226,0.801,26,163,189,275,69,17,117,146,584
373,Kyle Lowry,4,PG,49,21,1071,112,272,0.412,17,69,0.246,95,203,0.468,0.443,129,161,0.801,13,98,111,178,48,8,79,89,370
374,Shannon Brown,1,SG,23,5,202,28,74,0.378,7,25,0.28,21,49,0.429,0.426,10,14,0.714,6,15,21,10,7,3,14,24,73
374,Shannon Brown,2,SG,21,4,240,44,126,0.349,9,30,0.3,35,96,0.365,0.385,17,29,0.586,6,14,20,17,11,3,24,29,114
374,Shannon Brown,3,SG,15,4,218,41,111,0.369,9,29,0.31,32,82,0.39,0.41,14,23,0.609,5,13,18,17,10,1,19,27,105
374,Shannon Brown,4,SG,6,0,22,3,15,0.2,0,1,0,3,14,0.214,0.2,3,6,0.5,1,1,2,0,1,2,5,2,9
375,Jordan Farmar,1,PG,72,2,1090,124,294,0.422,45,137,0.328,79,157,0.503,0.498,27,38,0.711,22,97,119,137,44,7,73,77,320
375,Jordan Farmar,2,PG,82,0,1690,291,631,0.461,114,307,0.371,177,324,0.546,0.552,53,78,0.679,39,144,183,225,77,5,108,105,749
375,Jordan Farmar,3,PG,65,0,1192,161,412,0.391,49,146,0.336,112,266,0.421,0.45,45,77,0.584,22,95,117,155,57,10,87,105,416
375,Jordan Farmar,4,PG,82,0,1474,224,515,0.435,86,229,0.376,138,286,0.483,0.518,57,85,0.671,14,117,131,127,52,11,72,109,591
376,Sergio Rodriguez,1,PG,67,1,862,101,239,0.423,24,85,0.282,77,154,0.5,0.473,21,26,0.808,20,71,91,218,35,2,77,72,247
376,Sergio Rodriguez,2,PG,72,0,628,69,196,0.352,17,58,0.293,52,138,0.377,0.395,25,38,0.658,13,45,58,123,24,0,53,57,180
376,Sergio Rodriguez,3,PG,80,13,1225,129,329,0.392,37,114,0.325,92,215,0.428,0.448,61,77,0.792,43,87,130,286,54,2,119,133,356
376,Sergio Rodriguez,4,PG,66,8,1048,167,351,0.476,32,91,0.352,135,260,0.519,0.521,68,93,0.731,24,65,89,212,50,5,114,84,434
377,Maurice Ager,1,SG,32,1,214,22,70,0.314,5,15,0.333,17,55,0.309,0.35,20,33,0.606,1,20,21,7,4,3,15,27,69
377,Maurice Ager,2,SG,26,3,165,21,65,0.323,3,19,0.158,18,46,0.391,0.346,6,12,0.5,4,9,13,8,0,1,6,17,51
377,Maurice Ager,3,SG,12,3,77,5,27,0.185,0,8,0,5,19,0.263,0.185,5,6,0.833,1,3,4,4,0,1,3,11,15
377,Maurice Ager,4,SG,14,0,88,16,38,0.421,3,11,0.273,13,27,0.481,0.461,1,6,0.167,3,6,9,4,0,0,3,6,36
378,Mardy Collins,1,SF,52,9,777,87,228,0.382,13,47,0.277,74,181,0.409,0.41,48,82,0.585,28,76,104,83,32,3,57,75,235
378,Mardy Collins,2,SG,46,8,634,57,175,0.326,8,32,0.25,49,143,0.343,0.349,23,38,0.605,19,56,75,89,24,8,56,56,145
378,Mardy Collins,3,PG-SG,48,14,890,105,247,0.425,13,31,0.419,92,216,0.426,0.451,28,46,0.609,31,76,107,111,31,10,58,80,251
378,Mardy Collins,4,SG,9,0,75,8,23,0.348,0,3,0,8,20,0.4,0.348,4,9,0.444,2,6,8,10,2,0,5,7,20
379,Joel Freeland,1,PF,51,1,477,58,142,0.408,0,0,,58,142,0.408,0.408,18,27,0.667,40,79,119,13,13,11,19,67,134
379,Joel Freeland,2,C,52,0,727,77,162,0.475,0,2,0,77,160,0.481,0.475,20,29,0.69,88,120,208,36,10,22,32,95,174
379,Joel Freeland,3,C,48,8,617,74,151,0.49,0,0,,74,151,0.49,0.49,21,25,0.84,62,129,191,16,9,23,23,93,169
380,James White,1,SG,6,2,137,18,41,0.439,2,7,0.286,16,34,0.471,0.463,12,15,0.8,3,17,20,5,3,1,5,7,50
380,James White,2,SF,4,0,11,3,5,0.6,1,2,0.5,2,3,0.667,0.7,0,0,,0,0,0,1,1,1,3,2,7
380,James White,3,SF,57,16,435,50,116,0.431,14,41,0.341,36,75,0.48,0.491,11,19,0.579,5,43,48,29,13,4,17,44,125
381,Steve Novak,1,SF,35,1,191,18,50,0.36,13,39,0.333,5,11,0.455,0.49,2,2,1,4,22,26,6,5,0,4,21,51
381,Steve Novak,2,SF,35,0,264,49,102,0.48,34,71,0.479,15,31,0.484,0.647,3,4,0.75,4,31,35,6,2,3,4,17,135
381,Steve Novak,3,PF,71,3,1161,176,396,0.444,119,286,0.416,57,110,0.518,0.595,21,23,0.913,19,106,125,40,20,5,23,71,492
381,Steve Novak,4,SF,54,0,362,42,108,0.389,22,71,0.31,20,37,0.541,0.491,7,9,0.778,1,32,33,6,7,2,2,21,113
382,Solomon Jones,1,PF,58,8,666,65,128,0.508,0,1,0,65,127,0.512,0.508,59,75,0.787,49,87,136,11,11,42,25,124,189
382,Solomon Jones,2,PF,35,0,145,12,30,0.4,0,2,0,12,28,0.429,0.4,11,20,0.55,19,23,42,0,3,5,11,28,35
382,Solomon Jones,3,C,63,0,675,67,111,0.604,1,2,0.5,66,109,0.606,0.608,53,74,0.716,52,90,142,15,7,34,27,125,188
382,Solomon Jones,4,C,52,2,675,78,176,0.443,0,3,0,78,173,0.451,0.443,51,71,0.718,51,93,144,32,14,37,40,125,207
383,Paul Davis,1,C,31,0,180,22,52,0.423,0,0,,22,52,0.423,0.423,7,10,0.7,21,23,44,7,6,5,8,28,51
383,Paul Davis,2,PF,22,1,194,24,65,0.369,0,0,,24,65,0.369,0.369,6,10,0.6,25,22,47,10,6,6,9,33,54
383,Paul Davis,3,PF,27,1,320,40,98,0.408,0,1,0,40,97,0.412,0.408,27,34,0.794,28,39,67,12,10,3,13,44,107
383,Paul Davis,4,PF,2,0,8,2,4,0.5,0,0,,2,4,0.5,0.5,1,2,0.5,0,0,0,3,0,1,0,0,5
384,P.J. Tucker,1,SF,17,0,83,11,22,0.5,0,0,,11,22,0.5,0.5,8,14,0.571,11,12,23,3,2,0,6,12,30
384,P.J. Tucker,2,SG,79,45,1910,210,444,0.473,22,70,0.314,188,374,0.503,0.498,64,86,0.744,132,218,350,109,62,19,67,145,506
384,P.J. Tucker,3,SF,81,81,2490,265,615,0.431,74,191,0.387,191,424,0.45,0.491,156,201,0.776,161,368,529,141,110,23,102,204,760
384,P.J. Tucker,4,SF,78,63,2383,261,596,0.438,87,252,0.345,174,344,0.506,0.511,104,143,0.727,114,388,502,122,107,23,96,179,713
385,Craig Smith,1,PF,82,5,1537,246,463,0.531,0,6,0,246,457,0.538,0.531,116,186,0.624,149,267,416,49,51,18,74,223,608
385,Craig Smith,2,PF,77,11,1547,297,528,0.563,0,9,0,297,519,0.572,0.563,133,200,0.665,123,230,353,60,36,17,89,217,727
385,Craig Smith,3,PF,74,31,1460,289,514,0.562,0,1,0,289,513,0.563,0.562,168,248,0.677,98,186,284,79,31,19,105,184,746
385,Craig Smith,4,PF,75,2,1232,226,397,0.569,1,5,0.2,225,392,0.574,0.571,132,208,0.635,97,190,287,84,33,25,88,194,585
386,Bobby Jones,1,SF,44,5,336,43,93,0.462,1,9,0.111,42,84,0.5,0.468,23,41,0.561,22,35,57,16,11,1,18,59,110
386,Bobby Jones,2,SF,47,2,531,60,140,0.429,18,53,0.34,42,87,0.483,0.493,40,51,0.784,29,63,92,28,15,3,28,85,178
386,Bobby Jones,3,SF,25,0,222,26,64,0.406,9,23,0.391,17,41,0.415,0.477,23,28,0.821,11,27,38,11,5,1,14,46,84
386,Bobby Jones,4,SF,9,2,137,14,36,0.389,3,13,0.231,11,23,0.478,0.431,9,10,0.9,10,17,27,11,5,2,5,17,40
387,Kosta Perovic,1,C,7,0,38,3,10,0.3,0,0,,3,10,0.3,0.3,4,6,0.667,6,7,13,1,0,2,1,6,10
388,David Noel,1,PF,68,0,792,65,177,0.367,17,53,0.321,48,124,0.387,0.415,37,43,0.86,42,81,123,65,25,9,40,77,184
389,Denham Brown,No NBA Data,,,,,,,,,,,,,,,,,,,,,,,,,,
390,James Augustine,1,PF,2,0,7,1,3,0.333,0,0,,1,3,0.333,0.333,0,0,,1,2,3,2,0,0,0,2,2
390,James Augustine,2,PF,25,0,149,18,34,0.529,0,0,,18,34,0.529,0.529,4,8,0.5,16,14,30,2,5,2,6,18,40
391,Daniel Gibson,1,PG,60,16,988,98,231,0.424,52,124,0.419,46,107,0.43,0.537,28,39,0.718,28,64,92,69,23,8,44,94,276
391,Daniel Gibson,2,PG,58,26,1765,201,465,0.432,118,268,0.44,83,197,0.421,0.559,85,105,0.81,30,104,134,145,47,14,76,163,605
391,Daniel Gibson,3,PG,75,0,1795,206,527,0.391,108,283,0.382,98,244,0.402,0.493,66,86,0.767,31,124,155,132,44,16,61,163,586
391,Daniel Gibson,4,PG,56,10,1068,125,268,0.466,71,149,0.477,54,119,0.454,0.599,34,49,0.694,13,60,73,70,25,7,36,79,355
392,Marcus Vinicius,1,SF,13,0,103,7,15,0.467,3,7,0.429,4,8,0.5,0.567,5,7,0.714,2,9,11,5,2,1,6,10,22
392,Marcus Vinicius,2,SF,13,0,69,9,20,0.45,5,12,0.417,4,8,0.5,0.575,5,11,0.455,1,7,8,2,1,1,3,4,28
393,Lior Eliyahu,No NBA Data,,,,,,,,,,,,,,,,,,,,,,,,,,
394,Alexander Johnson,1,PF,59,19,753,91,169,0.538,0,0,,91,169,0.538,0.538,78,118,0.661,50,131,181,17,25,35,47,137,260
394,Alexander Johnson,2,PF,43,6,549,61,125,0.488,0,0,,61,125,0.488,0.488,57,83,0.687,32,62,94,13,13,10,42,80,179
395,Dee Brown,1,PG,49,0,450,32,98,0.327,6,28,0.214,26,70,0.371,0.357,24,37,0.649,8,32,40,83,22,7,31,51,94
395,Dee Brown,2,PG,19,11,261,18,49,0.367,7,24,0.292,11,25,0.44,0.439,3,5,0.6,7,22,29,36,10,0,17,28,46
395,Dee Brown,3,PG,17,11,233,17,44,0.386,6,20,0.3,11,24,0.458,0.455,1,3,0.333,7,21,28,33,10,0,14,22,41
395,Dee Brown,4,PG,2,0,28,1,5,0.2,1,4,0.25,0,1,0,0.3,2,2,1,0,1,1,3,0,0,3,6,5
396,Paul Millsap,1,PF,82,1,1472,209,398,0.525,1,3,0.333,208,395,0.527,0.526,140,208,0.673,183,240,423,62,67,74,94,236,559
396,Paul Millsap,2,PF,82,2,1702,253,502,0.504,0,4,0,253,498,0.508,0.504,155,229,0.677,167,293,460,81,72,73,87,269,661
396,Paul Millsap,3,PF,76,38,2290,400,749,0.534,0,4,0,400,745,0.537,0.534,228,326,0.699,251,403,654,138,78,73,129,288,1028
396,Paul Millsap,4,PF,82,8,2277,385,716,0.538,1,9,0.111,384,707,0.543,0.538,183,264,0.693,186,373,559,131,64,99,116,285,954
397,Vladimir Veremeenko,No NBA Data,,,,,,,,,,,,,,,,,,,,,,,,,,
398,Leon Powe,1,C,63,2,720,79,177,0.446,0,2,0,79,175,0.451,0.446,106,144,0.736,97,118,215,10,14,22,47,104,264
398,Leon Powe,2,C,56,5,809,154,269,0.572,0,1,0,154,268,0.575,0.572,137,193,0.71,95,132,227,15,15,16,43,127,445
398,Leon Powe,3,PF,70,7,1227,177,338,0.524,0,0,,177,338,0.524,0.524,184,267,0.689,145,200,345,46,24,38,76,192,538
398,Leon Powe,4,SF,20,2,236,21,49,0.429,0,0,,21,49,0.429,0.429,37,63,0.587,19,42,61,0,6,2,11,36,79
399,Ryan Hollins,1,C,27,0,185,20,36,0.556,0,0,,20,36,0.556,0.556,24,40,0.6,11,20,31,1,4,7,16,40,64
399,Ryan Hollins,2,PF,60,1,532,46,94,0.489,0,0,,46,94,0.489,0.489,55,82,0.671,53,54,107,14,10,30,25,96,147
399,Ryan Hollins,3,C,45,3,444,50,94,0.532,0,0,,50,94,0.532,0.532,43,72,0.597,46,51,97,7,7,32,24,78,143
399,Ryan Hollins,4,C,18,1,184,19,35,0.543,0,0,,19,35,0.543,0.543,26,39,0.667,19,17,36,4,3,17,10,34,64
400,Cheikh Samb,1,C,4,0,31,3,4,0.75,0,0,,3,4,0.75,0.75,1,2,0.5,3,4,7,0,1,2,1,8,7
400,Cheikh Samb,2,C,18,0,83,6,32,0.188,0,3,0,6,29,0.207,0.188,3,7,0.429,10,14,24,1,3,10,3,7,15
400,Cheikh Samb,3,C,6,0,24,2,13,0.154,0,1,0,2,12,0.167,0.154,0,0,,2,7,9,1,2,5,2,4,4
400,Cheikh Samb,4,C,10,0,51,4,16,0.25,0,2,0,4,14,0.286,0.25,3,5,0.6,7,6,13,0,1,5,1,3,11
401,Guillermo Diaz,1,SG,6,0,18,1,4,0.25,0,1,0,1,3,0.333,0.25,3,5,0.6,2,0,2,1,0,0,0,0,5
402,Yotam Halperin,No NBA Data,,,,,,,,,,,,,,,,,,,,,,,,,,
403,Hassan Adams,1,SG,61,8,495,75,135,0.556,0,1,0,75,134,0.56,0.556,24,36,0.667,35,42,77,13,17,4,22,47,174
403,Hassan Adams,2,SG,12,0,52,4,13,0.308,0,0,,4,13,0.308,0.308,3,6,0.5,1,6,7,1,1,1,4,4,11
404,Ejike Ugboaja,No NBA Data,,,,,,,,,,,,,,,,,,,,,,,,,,
405,Edin Bavcic,No NBA Data,,,,,,,,,,,,,,,,,,,,,,,,,,
406,Loukas Mavrokefalidis,No NBA Data,,,,,,,,,,,,,,,,,,,,,,,,,,
407,J.R. Pinnock,No NBA Data,,,,,,,,,,,,,,,,,,,,,,,,,,
408,Damir Markota,1,PF,30,0,170,19,52,0.365,6,16,0.375,13,36,0.361,0.423,7,11,0.636,11,20,31,6,3,1,15,22,51
409,Will Blalock,1,PG,14,0,166,9,30,0.3,1,5,0.2,8,25,0.32,0.317,6,6,1,6,9,15,17,5,0,12,9,25
410,Greg Oden,1,C,61,39,1314,198,351,0.564,0,0,,198,351,0.564,0.564,144,226,0.637,169,255,424,31,25,69,87,238,540
410,Greg Oden,2,C,21,21,502,92,152,0.605,0,0,,92,152,0.605,0.605,49,64,0.766,64,114,178,19,8,48,39,84,233
410,Greg Oden,3,C,23,6,212,27,49,0.551,0,0,,27,49,0.551,0.551,13,23,0.565,23,31,54,1,7,13,12,52,67
411,Kevin Durant,1,SG,80,80,2768,587,1366,0.43,59,205,0.288,528,1161,0.455,0.451,391,448,0.873,70,278,348,192,78,75,232,122,1624
411,Kevin Durant,2,SF,74,74,2885,661,1390,0.476,97,230,0.422,564,1160,0.486,0.51,452,524,0.863,77,405,482,205,96,53,225,134,1871
411,Kevin Durant,3,SF,82,82,3239,794,1668,0.476,128,351,0.365,666,1317,0.506,0.514,756,840,0.9,105,518,623,231,112,84,271,171,2472
411,Kevin Durant,4,SF,78,78,3038,711,1538,0.462,145,414,0.35,566,1124,0.504,0.509,594,675,0.88,57,476,533,214,88,76,218,159,2161
412,Al Horford,1,C,81,77,2540,333,668,0.499,0,5,0,333,663,0.502,0.499,155,212,0.731,248,537,785,124,60,76,137,267,821
412,Al Horford,2,C,67,67,2242,312,594,0.525,0,1,0,312,593,0.526,0.525,149,205,0.727,145,479,624,163,53,95,103,190,773
412,Al Horford,3,C,81,81,2845,467,847,0.551,1,1,1,466,846,0.551,0.552,213,270,0.789,236,563,799,189,59,91,122,225,1148
412,Al Horford,4,C,77,77,2704,513,921,0.557,2,4,0.5,511,917,0.557,0.558,150,188,0.798,182,536,718,266,59,80,119,193,1178
413,Mike Conley,1,PG,53,46,1381,189,442,0.428,30,91,0.33,159,351,0.453,0.462,90,123,0.732,21,118,139,222,44,2,89,85,498
413,Mike Conley,2,PG,82,61,2508,323,730,0.442,88,217,0.406,235,513,0.458,0.503,161,197,0.817,25,251,276,354,90,8,143,146,895
413,Mike Conley,3,PG,80,80,2569,369,830,0.445,82,212,0.387,287,618,0.464,0.494,139,187,0.743,30,161,191,425,109,12,170,178,959
413,Mike Conley,4,PG,81,81,2872,423,953,0.444,80,217,0.369,343,736,0.466,0.486,181,247,0.733,32,215,247,528,144,18,176,182,1107
414,Jeff Green,1,SF,80,52,2253,320,749,0.427,21,76,0.276,299,673,0.444,0.441,177,238,0.744,101,278,379,119,46,49,158,198,838
414,Jeff Green,2,PF,78,78,2873,476,1068,0.446,96,247,0.389,380,821,0.463,0.491,242,307,0.788,120,399,519,155,81,33,173,202,1290
414,Jeff Green,3,PF,82,82,3043,485,1070,0.453,104,312,0.333,381,758,0.503,0.502,165,223,0.74,112,378,490,134,104,72,135,221,1239
414,Jeff Green,4,PF-SF,75,51,2427,368,820,0.449,64,211,0.303,304,609,0.499,0.488,198,244,0.811,73,287,360,108,53,37,99,210,998
415,Yi Jianlian,1,PF,66,49,1647,219,520,0.421,6,21,0.286,213,499,0.427,0.427,122,145,0.841,106,238,344,55,36,56,90,153,566
415,Yi Jianlian,2,PF,61,52,1421,191,500,0.382,48,140,0.343,143,360,0.397,0.43,95,123,0.772,67,259,326,60,29,36,70,157,525
415,Yi Jianlian,3,PF,52,51,1655,227,563,0.403,15,41,0.366,212,522,0.406,0.417,154,193,0.798,115,257,372,47,37,52,77,170,623
415,Yi Jianlian,4,PF,63,11,1112,145,347,0.418,3,13,0.231,142,334,0.425,0.422,62,91,0.681,79,169,248,25,27,32,51,115,355
416,Corey Brewer,1,SF,79,35,1803,182,486,0.374,7,36,0.194,175,450,0.389,0.382,88,110,0.8,82,210,292,111,76,25,89,188,459
416,Corey Brewer,2,SF,15,8,307,37,90,0.411,5,12,0.417,32,78,0.41,0.439,14,19,0.737,18,31,49,25,15,3,13,37,93
416,Corey Brewer,3,SG,82,82,2482,409,949,0.431,82,237,0.346,327,712,0.459,0.474,166,256,0.648,70,209,279,193,117,29,164,224,1066
416,Corey Brewer,4,SF-SG,69,24,1510,193,488,0.395,30,112,0.268,163,376,0.434,0.426,136,192,0.708,57,118,175,89,100,16,87,159,552
417,Brandan Wright,1,PF,38,6,376,62,112,0.554,0,0,,62,112,0.554,0.554,27,40,0.675,38,61,99,9,6,22,13,36,151
417,Brandan Wright,2,PF,39,23,688,130,246,0.528,0,4,0,130,242,0.537,0.528,63,85,0.741,62,95,157,21,22,37,23,74,323
417,Brandan Wright,3,PF,37,2,379,60,117,0.513,0,0,,60,117,0.513,0.513,21,31,0.677,31,58,89,12,11,17,14,34,141
417,Brandan Wright,4,PF,21,1,195,38,63,0.603,0,0,,38,63,0.603,0.603,7,14,0.5,14,27,41,5,3,10,10,19,83
418,Joakim Noah,1,C,74,31,1534,177,367,0.482,0,1,0,177,366,0.484,0.482,134,194,0.691,174,242,416,84,68,64,89,173,488
418,Joakim Noah,2,C,80,55,1938,207,372,0.556,0,1,0,207,371,0.558,0.556,123,182,0.676,244,362,606,106,49,110,82,238,537
418,Joakim Noah,3,C,64,54,1925,262,520,0.504,0,0,,262,520,0.504,0.504,163,219,0.744,220,484,704,132,32,100,117,198,687
418,Joakim Noah,4,C,48,48,1576,211,402,0.525,0,1,0,211,401,0.526,0.525,139,188,0.739,182,316,498,107,48,72,90,156,561
419,Spencer Hawes,1,C,71,8,931,146,318,0.459,4,21,0.19,142,297,0.478,0.465,38,58,0.655,68,162,230,44,14,40,56,128,334
419,Spencer Hawes,2,C,77,51,2259,373,800,0.466,40,115,0.348,333,685,0.486,0.491,90,136,0.662,148,401,549,149,44,93,160,249,876
419,Spencer Hawes,3,C,72,59,1904,312,666,0.468,26,87,0.299,286,579,0.494,0.488,73,106,0.689,145,291,436,158,32,83,131,200,723
419,Spencer Hawes,4,C,81,81,1718,264,568,0.465,9,37,0.243,255,531,0.48,0.473,47,88,0.534,129,336,465,121,29,71,97,201,584
420,Acie Law,1,PG,56,6,865,95,237,0.401,7,34,0.206,88,203,0.433,0.416,38,48,0.792,12,45,57,113,29,0,56,73,235
420,Acie Law,2,PG,55,1,560,52,139,0.374,9,29,0.31,43,110,0.391,0.406,49,60,0.817,6,52,58,86,11,3,29,43,162
420,Acie Law,3,PG,26,1,234,35,75,0.467,5,16,0.313,30,59,0.508,0.5,38,49,0.776,3,14,17,26,11,1,17,16,113
420,Acie Law,4,PG,5,0,66,9,14,0.643,1,3,0.333,8,11,0.727,0.679,12,15,0.8,0,2,2,7,6,0,2,5,31
421,Thaddeus Young,1,PF,74,22,1554,264,490,0.539,6,19,0.316,258,471,0.548,0.545,76,103,0.738,120,192,312,58,73,8,64,126,610
421,Thaddeus Young,2,PF,75,71,2580,475,960,0.495,56,164,0.341,419,796,0.526,0.524,139,189,0.735,139,238,377,86,100,23,118,165,1145
421,Thaddeus Young,3,PF,67,45,2145,382,813,0.47,48,138,0.348,334,675,0.495,0.499,114,165,0.691,130,220,350,97,81,15,126,133,926
421,Thaddeus Young,4,PF,82,1,2135,458,847,0.541,6,22,0.273,452,825,0.548,0.544,123,174,0.707,153,281,434,82,90,26,99,170,1045
422,Julian Wright,1,SF,57,1,640,90,169,0.533,10,24,0.417,80,145,0.552,0.562,33,52,0.635,33,84,117,40,29,12,34,43,223
422,Julian Wright,2,SF,54,19,772,109,234,0.466,2,21,0.095,107,213,0.502,0.47,17,30,0.567,46,106,152,43,35,19,43,49,237
422,Julian Wright,3,SF,68,14,871,116,232,0.5,2,6,0.333,114,226,0.504,0.504,25,41,0.61,58,86,144,41,29,18,44,45,259
422,Julian Wright,4,SF,52,6,766,82,160,0.513,2,10,0.2,80,150,0.533,0.519,22,43,0.512,47,71,118,58,39,20,43,45,188
423,Al Thornton,1,PF,79,31,2158,374,871,0.429,43,130,0.331,331,741,0.447,0.454,214,288,0.743,98,260,358,98,46,43,128,195,1005
423,Al Thornton,2,SF,71,67,2654,469,1051,0.446,20,79,0.253,449,972,0.462,0.456,236,313,0.754,122,246,368,103,59,62,130,227,1194
423,Al Thornton,3,SF,75,46,2079,320,676,0.473,11,31,0.355,309,645,0.479,0.482,153,211,0.725,116,178,294,90,45,35,102,206,804
423,Al Thornton,4,SF,51,30,1405,220,460,0.478,5,14,0.357,215,446,0.482,0.484,103,139,0.741,85,107,192,61,25,22,66,144,548
424,Rodney Stuckey,1,PG,57,2,1081,153,382,0.401,3,16,0.188,150,366,0.41,0.404,127,156,0.814,32,97,129,160,49,6,78,113,436
424,Rodney Stuckey,2,PG,79,65,2517,401,913,0.439,23,78,0.295,378,835,0.453,0.452,233,290,0.803,69,206,275,387,78,11,173,217,1058
424,Rodney Stuckey,3,PG,73,67,2499,449,1109,0.405,18,79,0.228,431,1030,0.418,0.413,299,359,0.833,67,214,281,348,101,12,163,205,1215
424,Rodney Stuckey,4,PG,70,54,2183,363,827,0.439,26,90,0.289,337,737,0.457,0.455,330,381,0.866,70,146,216,361,76,10,155,177,1082
425,Nick Young,1,SG,75,2,1158,210,478,0.439,40,100,0.4,170,378,0.45,0.481,101,124,0.815,23,92,115,63,35,7,94,130,561
425,Nick Young,2,SG,82,5,1837,336,756,0.444,56,164,0.341,280,592,0.473,0.481,164,193,0.85,31,119,150,95,39,20,92,140,892
425,Nick Young,3,SG,74,23,1421,233,558,0.418,69,170,0.406,164,388,0.423,0.479,104,130,0.8,20,82,102,48,28,8,56,147,639
425,Nick Young,4,SG,64,40,2034,412,935,0.441,105,271,0.387,307,664,0.462,0.497,186,228,0.816,26,148,174,75,45,17,90,144,1115
426,Sean Williams,1,C,73,29,1278,164,305,0.538,0,0,,164,305,0.538,0.538,81,133,0.609,115,207,322,28,28,106,70,193,409
426,Sean Williams,2,PF,33,0,366,30,72,0.417,0,0,,30,72,0.417,0.417,20,32,0.625,34,45,79,13,7,29,20,72,80
426,Sean Williams,3,PF,20,0,227,21,49,0.429,0,1,0,21,48,0.438,0.429,10,19,0.526,21,25,46,1,8,19,20,41,52
426,Sean Williams,4,C,11,0,107,14,22,0.636,0,0,,14,22,0.636,0.636,12,13,0.923,13,12,25,5,4,8,10,18,40
427,Marco Belinelli,1,SG,33,0,241,36,93,0.387,16,41,0.39,20,52,0.385,0.473,7,9,0.778,3,11,14,15,5,0,12,15,95
427,Marco Belinelli,2,SG,42,23,882,140,317,0.442,52,131,0.397,88,186,0.473,0.524,40,52,0.769,10,61,71,88,36,1,59,73,372
427,Marco Belinelli,3,SG,66,1,1121,154,379,0.406,60,158,0.38,94,221,0.425,0.485,101,121,0.835,14,81,95,89,42,5,60,80,469
427,Marco Belinelli,4,SG,80,69,1957,302,691,0.437,134,324,0.414,168,367,0.458,0.534,98,125,0.784,17,134,151,92,38,6,77,146,836
428,Javaris Crittenton,1,SG,50,0,679,98,233,0.421,10,37,0.27,88,196,0.449,0.442,72,104,0.692,27,83,110,51,19,2,55,47,278
428,Javaris Crittenton,2,SG,22,0,171,26,53,0.491,1,3,0.333,25,50,0.5,0.5,19,28,0.679,7,14,21,18,7,0,22,12,72
428,Javaris Crittenton,3,SG,28,0,508,72,180,0.4,9,34,0.265,63,146,0.432,0.425,53,76,0.697,20,69,89,33,12,2,33,35,206
428,Javaris Crittenton,4,PG-SG,63,10,1174,131,285,0.46,2,15,0.133,129,270,0.478,0.463,53,92,0.576,57,109,166,150,40,6,82,101,317
429,Jason Smith,1,PF,76,1,1107,141,310,0.455,4,14,0.286,137,296,0.463,0.461,54,82,0.659,77,153,230,20,22,50,48,142,340
429,Jason Smith,2,PF,56,2,658,75,174,0.431,10,29,0.345,65,145,0.448,0.46,29,42,0.69,54,81,135,33,21,28,35,110,189
429,Jason Smith,3,C,77,6,1102,136,307,0.443,0,2,0,136,305,0.446,0.443,59,70,0.843,89,152,241,36,26,32,53,150,331
429,Jason Smith,4,PF,40,29,947,181,348,0.52,1,9,0.111,180,339,0.531,0.522,33,47,0.702,72,124,196,34,21,41,40,102,396
430,Daequan Cook,1,SG,59,19,1441,196,514,0.381,79,238,0.332,117,276,0.424,0.458,47,57,0.825,20,157,177,75,23,9,63,157,518
430,Daequan Cook,2,SF,75,4,1833,242,645,0.375,153,395,0.387,89,250,0.356,0.494,49,56,0.875,19,170,189,71,39,10,42,125,686
430,Daequan Cook,3,SG,45,3,691,81,253,0.32,40,126,0.317,41,127,0.323,0.399,21,25,0.84,9,73,82,43,14,10,24,50,223
430,Daequan Cook,4,SG,43,0,598,79,181,0.436,65,154,0.422,14,27,0.519,0.616,16,20,0.8,8,64,72,20,14,1,17,51,239
431,Jared Dudley,1,PF,73,14,1384,163,348,0.468,9,41,0.22,154,307,0.502,0.481,87,118,0.737,121,165,286,81,55,10,50,128,422
431,Jared Dudley,2,SF,68,7,1155,136,285,0.477,29,74,0.392,107,211,0.507,0.528,71,105,0.676,82,123,205,56,57,8,43,105,372
431,Jared Dudley,3,SF,20,7,427,45,96,0.469,3,8,0.375,42,88,0.477,0.484,15,24,0.625,25,34,59,19,18,2,10,40,108
431,Jared Dudley,4,SF,48,0,728,91,189,0.481,26,66,0.394,65,123,0.528,0.55,56,81,0.691,57,89,146,37,39,6,33,65,264
432,Wilson Chandler,1,SF,35,16,685,106,242,0.438,9,30,0.3,97,212,0.458,0.457,34,54,0.63,38,89,127,33,15,16,27,83,255
432,Wilson Chandler,2,SF,82,70,2735,455,1054,0.432,103,314,0.328,352,740,0.476,0.481,171,215,0.795,91,354,445,170,71,75,139,250,1184
432,Wilson Chandler,3,SG,65,64,2320,412,860,0.479,40,150,0.267,372,710,0.524,0.502,129,160,0.806,93,255,348,138,46,49,108,184,993
432,Wilson Chandler,4,SF,72,49,2401,429,953,0.45,112,320,0.35,317,633,0.501,0.509,130,161,0.807,75,333,408,120,48,94,104,199,1100
433,Rudy Fernandez,1,SG,78,4,1993,268,630,0.425,159,398,0.399,109,232,0.47,0.552,120,143,0.839,47,160,207,159,69,12,86,111,815
433,Rudy Fernandez,2,SG,62,2,1441,160,423,0.378,98,266,0.368,62,157,0.395,0.494,85,98,0.867,35,129,164,127,62,11,72,87,503
433,Rudy Fernandez,3,SG,78,3,1821,213,575,0.37,116,361,0.321,97,214,0.453,0.471,126,146,0.863,37,135,172,193,87,14,88,134,668
433,Rudy Fernandez,4,SG,31,1,710,99,225,0.44,40,122,0.328,59,103,0.573,0.529,30,43,0.698,9,56,65,75,31,3,40,37,268
434,Morris Almond,1,SG,9,0,39,4,15,0.267,1,4,0.25,3,11,0.273,0.3,4,6,0.667,0,2,2,3,1,0,2,5,13
434,Morris Almond,2,SG,25,1,255,33,81,0.407,5,17,0.294,28,64,0.438,0.438,21,26,0.808,9,27,36,7,4,4,16,31,92
434,Morris Almond,3,SG,4,0,67,6,17,0.353,1,3,0.333,5,14,0.357,0.382,1,3,0.333,1,7,8,2,7,0,1,6,14
435,Aaron Brooks,1,PG,51,0,608,93,225,0.413,36,109,0.33,57,116,0.491,0.493,42,49,0.857,13,43,56,87,13,5,44,69,264
435,Aaron Brooks,2,PG,80,35,1998,316,783,0.404,113,309,0.366,203,474,0.428,0.476,149,172,0.866,33,124,157,238,46,8,125,152,894
435,Aaron Brooks,3,PG,82,82,2919,575,1331,0.432,209,525,0.398,366,806,0.454,0.511,245,298,0.822,54,161,215,434,69,14,232,199,1604
435,Aaron Brooks,4,PG,59,12,1284,220,587,0.375,70,236,0.297,150,351,0.427,0.434,124,140,0.886,20,58,78,233,34,3,99,115,634
436,Arron Afflalo,1,SG,75,9,970,99,241,0.411,10,48,0.208,89,193,0.461,0.432,68,87,0.782,36,101,137,52,31,8,34,83,276
436,Arron Afflalo,2,SG,74,8,1234,131,300,0.437,43,107,0.402,88,193,0.456,0.508,58,71,0.817,30,104,134,44,28,13,43,144,363
436,Arron Afflalo,3,SG,82,75,2221,272,585,0.465,108,249,0.434,164,336,0.488,0.557,72,98,0.735,59,193,252,138,46,30,74,225,724
436,Arron Afflalo,4,SG,69,69,2324,312,627,0.498,105,248,0.423,207,379,0.546,0.581,138,163,0.847,45,206,251,168,34,31,71,153,867
437,Tiago Splitter,1,C,60,6,738,101,191,0.529,0,1,0,101,190,0.532,0.529,76,140,0.543,72,129,201,26,29,17,32,91,278
437,Tiago Splitter,2,C,59,2,1121,212,343,0.618,0,0,,212,343,0.618,0.618,125,181,0.691,93,213,306,65,21,47,87,134,549
437,Tiago Splitter,3,PF,81,58,1997,315,563,0.56,0,2,0,315,561,0.561,0.56,208,285,0.73,144,371,515,130,63,64,100,161,838
437,Tiago Splitter,4,C,59,50,1271,181,346,0.523,0,3,0,181,343,0.528,0.523,121,173,0.699,123,240,363,90,29,31,75,117,483
438,Alando Tucker,1,SF,6,0,48,8,22,0.364,1,4,0.25,7,18,0.389,0.386,5,6,0.833,4,4,8,0,0,1,0,2,22
438,Alando Tucker,2,SG,30,1,282,52,121,0.43,8,23,0.348,44,98,0.449,0.463,26,33,0.788,19,12,31,12,5,1,14,14,138
438,Alando Tucker,3,SF,15,0,96,17,39,0.436,1,7,0.143,16,32,0.5,0.449,16,21,0.762,6,4,10,4,0,0,5,6,51
438,Alando Tucker,4,SF,11,0,71,13,30,0.433,1,7,0.143,12,23,0.522,0.45,16,21,0.762,5,2,7,3,0,0,4,5,43
439,Petteri Koponen,No NBA Data,,,,,,,,,,,,,,,,,,,,,,,,,,
440,Carl Landry,1,PF,42,0,711,135,219,0.616,0,1,0,135,218,0.619,0.616,72,109,0.661,96,111,207,21,17,7,26,98,342
440,Carl Landry,2,PF,69,0,1467,240,418,0.574,1,3,0.333,239,415,0.576,0.575,157,193,0.813,124,219,343,39,26,31,68,166,638
440,Carl Landry,3,PF,80,29,2469,499,931,0.536,1,3,0.333,498,928,0.537,0.537,344,427,0.806,188,280,468,66,55,63,136,234,1343
440,Carl Landry,4,PF,52,1,1415,302,552,0.547,0,0,,302,552,0.547,0.547,235,280,0.839,122,164,286,40,28,46,86,146,839
441,Gabe Pruitt,1,PG,15,0,95,14,39,0.359,3,12,0.25,11,27,0.407,0.397,1,2,0.5,1,7,8,13,5,0,5,10,32
441,Gabe Pruitt,2,SG,47,0,366,31,101,0.307,14,48,0.292,17,53,0.321,0.376,17,21,0.81,9,34,43,39,15,3,19,34,93
442,Marcus Williams,1,PF-SF,11,0,36,5,20,0.25,0,0,,5,20,0.25,0.25,0,0,,4,8,12,3,1,1,0,3,10
442,Marcus Williams,2,SF,1,0,2,0,1,0,0,0,,0,1,0,0,0,0,,0,0,0,0,0,1,0,0,0
442,Marcus Williams,3,PF,10,0,34,5,19,0.263,0,0,,5,19,0.263,0.263,0,0,,4,8,12,3,1,0,0,3,10
442,Marcus Williams,4,PF,2,0,3,2,2,1,0,0,,2,2,1,1,0,0,,0,0,0,0,0,0,0,1,4
443,Nick Fazekas,1,PF,26,0,269,46,82,0.561,0,2,0,46,80,0.575,0.561,15,22,0.682,34,55,89,11,8,11,13,25,107
443,Nick Fazekas,2,PF,4,0,9,2,5,0.4,0,0,,2,5,0.4,0.4,0,0,,1,2,3,0,0,0,0,0,4
443,Nick Fazekas,3,PF,22,0,260,44,77,0.571,0,2,0,44,75,0.587,0.571,15,22,0.682,33,53,86,11,8,11,13,25,103
444,Glen Davis,1,C,69,1,940,107,221,0.484,0,0,,107,221,0.484,0.484,99,150,0.66,95,113,208,28,31,20,65,160,313
444,Glen Davis,2,C,76,16,1637,199,450,0.442,2,5,0.4,197,445,0.443,0.444,130,178,0.73,121,180,301,69,53,19,71,230,530
444,Glen Davis,3,PF,54,1,933,122,279,0.437,0,4,0,122,275,0.444,0.437,96,138,0.696,101,104,205,35,21,14,53,132,340
444,Glen Davis,4,C,78,13,2298,359,801,0.448,2,15,0.133,357,786,0.454,0.449,195,265,0.736,101,324,425,92,78,30,85,231,915
445,Jermareo Davidson,1,SF,38,2,322,51,125,0.408,0,0,,51,125,0.408,0.408,18,28,0.643,21,41,62,13,7,15,17,46,120
445,Jermareo Davidson,2,SF,14,0,111,17,35,0.486,0,0,,17,35,0.486,0.486,8,17,0.471,10,24,34,1,2,3,5,12,42
446,Josh McRoberts,1,PF,8,0,28,6,10,0.6,0,1,0,6,9,0.667,0.6,0,0,,2,8,10,2,1,0,2,1,12
446,Josh McRoberts,2,PF,33,0,279,35,83,0.422,0,10,0,35,73,0.479,0.422,10,13,0.769,26,48,74,16,12,16,12,41,80
446,Josh McRoberts,3,C,42,3,524,76,146,0.521,8,23,0.348,68,123,0.553,0.548,19,38,0.5,40,87,127,44,17,16,19,74,179
446,Josh McRoberts,4,PF,72,51,1597,211,386,0.547,23,60,0.383,188,326,0.577,0.576,88,119,0.739,109,273,382,150,47,57,93,165,533
447,Kyrylo Fesenko,1,C,9,0,70,6,16,0.375,0,0,,6,16,0.375,0.375,2,4,0.5,14,11,25,2,0,3,8,19,14
447,Kyrylo Fesenko,2,C,21,1,156,21,36,0.583,0,0,,21,36,0.583,0.583,7,21,0.333,14,23,37,4,7,15,9,35,49
447,Kyrylo Fesenko,3,C,49,5,408,52,95,0.547,0,1,0,52,94,0.553,0.547,24,57,0.421,33,57,90,15,6,19,24,78,128
447,Kyrylo Fesenko,4,C,53,1,456,44,100,0.44,0,1,0,44,99,0.444,0.44,18,46,0.391,34,74,108,18,4,16,25,90,106
448,Stanko Barac,No NBA Data,,,,,,,,,,,,,,,,,,,,,,,,,,
449,Sun Yue,1,SG,10,0,28,3,11,0.273,0,6,0,3,5,0.6,0.273,0,0,,0,0,0,2,1,1,3,10,6
450,Chris Richard,1,C,52,3,556,41,87,0.471,0,0,,41,87,0.471,0.471,16,27,0.593,52,83,135,18,10,12,24,83,98
450,Chris Richard,2,PF,18,0,224,15,29,0.517,0,0,,15,29,0.517,0.517,7,11,0.636,19,40,59,7,8,4,14,50,37
451,Derrick Byars,1,PF,2,0,37,3,11,0.273,0,6,0,3,5,0.6,0.273,4,4,1,6,5,11,1,2,0,0,2,10
452,Adam Haluska,No NBA Data,,,,,,,,,,,,,,,,,,,,,,,,,,
453,Reyshawn Terry,No NBA Data,,,,,,,,,,,,,,,,,,,,,,,,,,
454,Jared Jordan,No NBA Data,,,,,,,,,,,,,,,,,,,,,,,,,,
455,Stephane Lasme,1,PF-SF,16,4,303,32,71,0.451,0,0,,32,71,0.451,0.451,19,32,0.594,26,27,53,3,13,22,15,35,83
455,Stephane Lasme,2,SF,1,0,0,0,0,,0,0,,0,0,,,0,0,,0,0,0,0,0,0,0,0,0
455,Stephane Lasme,3,PF,15,4,303,32,71,0.451,0,0,,32,71,0.451,0.451,19,32,0.594,26,27,53,3,13,22,15,35,83
456,Dominic McGuire,1,SG,70,1,695,39,103,0.379,1,6,0.167,38,97,0.392,0.383,14,32,0.438,53,86,139,40,20,26,40,76,93
456,Dominic McGuire,2,SF,79,57,2072,140,324,0.432,2,4,0.5,138,320,0.431,0.435,74,102,0.725,113,315,428,198,62,74,92,153,356
456,Dominic McGuire,3,SF,51,2,307,19,52,0.365,0,0,,19,52,0.365,0.365,0,7,0,23,56,79,11,5,4,17,35,38
456,Dominic McGuire,4,SF,41,0,240,15,40,0.375,0,0,,15,40,0.375,0.375,0,5,0,17,44,61,8,4,3,10,32,30
457,Marc Gasol,1,C,82,75,2521,350,661,0.53,0,1,0,350,660,0.53,0.53,275,375,0.733,201,404,605,143,63,90,164,265,975
457,Marc Gasol,2,C,69,69,2469,378,651,0.581,0,1,0,378,650,0.582,0.581,252,376,0.67,208,432,640,165,69,109,135,254,1008
457,Marc Gasol,3,C,81,81,2586,364,691,0.527,3,7,0.429,361,684,0.528,0.529,220,294,0.748,154,415,569,200,74,136,146,265,951
457,Marc Gasol,4,C,65,65,2370,357,740,0.482,1,12,0.083,356,728,0.489,0.483,237,317,0.748,120,459,579,204,62,121,121,201,952
458,Aaron Gray,1,C,61,1,613,103,204,0.505,0,1,0,103,203,0.507,0.505,56,99,0.566,70,98,168,41,21,16,57,117,262
458,Aaron Gray,2,C,56,18,715,81,167,0.485,0,1,0,81,166,0.488,0.485,34,59,0.576,84,136,220,46,14,18,40,135,196
458,Aaron Gray,3,C,32,0,311,42,82,0.512,0,0,,42,82,0.512,0.512,20,28,0.714,45,61,106,22,9,11,18,54,104
458,Aaron Gray,4,C,8,0,50,8,21,0.381,0,0,,8,21,0.381,0.381,2,7,0.286,5,11,16,2,0,0,1,10,18
459,Renaldas Seibutis,No NBA Data,,,,,,,,,,,,,,,,,,,,,,,,,,
460,JamesOn Curry,1,PG,1,0,0,0,0,,0,0,,0,0,,,0,0,,0,0,0,0,0,0,0,0,0
461,Taurean Green,1,SG-PG,17,0,74,7,25,0.28,2,11,0.182,5,14,0.357,0.32,11,12,0.917,0,10,10,11,2,0,9,5,27
461,Taurean Green,2,PG,8,0,44,4,16,0.25,1,8,0.125,3,8,0.375,0.281,8,8,1,0,4,4,8,1,0,7,3,17
461,Taurean Green,3,SG,9,0,30,3,9,0.333,1,3,0.333,2,6,0.333,0.389,3,4,0.75,0,6,6,3,1,0,2,2,10
462,Demetris Nichols,1,SF,14,0,44,6,23,0.261,3,13,0.231,3,10,0.3,0.326,0,0,,0,5,5,1,0,3,4,4,15
462,Demetris Nichols,2,SF,3,0,14,1,8,0.125,0,3,0,1,5,0.2,0.125,0,0,,0,1,1,0,0,0,2,0,2
462,Demetris Nichols,3,SF,11,0,30,5,15,0.333,3,10,0.3,2,5,0.4,0.433,0,0,,0,4,4,1,0,3,2,4,13
462,Demetris Nichols,4,SF,4,0,14,3,9,0.333,0,2,0,3,7,0.429,0.333,1,2,0.5,0,2,2,1,0,1,0,1,7
463,Brad Newley,No NBA Data,,,,,,,,,,,,,,,,,,,,,,,,,,
464,Herbert Hill,No NBA Data,,,,,,,,,,,,,,,,,,,,,,,,,,
465,Ramon Sessions,1,PG,17,7,450,51,117,0.436,3,7,0.429,48,110,0.436,0.449,32,41,0.78,8,50,58,127,17,3,36,26,137
465,Ramon Sessions,2,PG,79,39,2173,345,775,0.445,6,34,0.176,339,741,0.457,0.449,281,354,0.794,64,205,269,452,83,7,152,158,977
465,Ramon Sessions,3,PG,82,1,1732,253,555,0.456,1,15,0.067,252,540,0.467,0.457,167,233,0.717,58,156,214,258,55,5,137,137,674
465,Ramon Sessions,4,PG,81,38,2133,362,776,0.466,3,15,0.2,359,761,0.472,0.468,348,423,0.823,46,209,255,419,60,8,178,93,1075
466,Sammy Mejia,No NBA Data,,,,,,,,,,,,,,,,,,,,,,,,,,
467,Giorgos Printezis,No NBA Data,,,,,,,,,,,,,,,,,,,,,,,,,,
468,D.J. Strawberry,1,SG,33,0,270,29,92,0.315,6,25,0.24,23,67,0.343,0.348,9,19,0.474,9,19,28,30,12,6,11,36,73
469,Milovan Rakovic,No NBA Data,,,,,,,,,,,,,,,,,,,,,,,,,,
470,Derrick Rose,1,PG,81,80,3000,574,1208,0.475,16,72,0.222,558,1136,0.491,0.482,197,250,0.788,96,221,317,512,66,18,202,125,1361
470,Derrick Rose,2,PG,78,78,2871,672,1373,0.489,16,60,0.267,656,1313,0.5,0.495,259,338,0.766,65,228,293,469,57,27,217,96,1619
470,Derrick Rose,3,PG,81,81,3026,711,1597,0.445,128,385,0.332,583,1212,0.481,0.485,476,555,0.858,81,249,330,623,85,51,278,136,2026
470,Derrick Rose,4,PG,39,39,1375,302,695,0.435,54,173,0.312,248,522,0.475,0.473,194,239,0.812,26,105,131,307,35,28,119,52,852
471,Michael Beasley,1,PF,81,19,2009,452,957,0.472,33,81,0.407,419,876,0.478,0.49,186,241,0.772,110,329,439,83,41,37,121,184,1123
471,Michael Beasley,2,PF,78,78,2328,468,1040,0.45,28,102,0.275,440,938,0.469,0.463,192,240,0.8,123,375,498,100,80,49,131,221,1156
471,Michael Beasley,3,SF,73,73,2361,561,1246,0.45,60,164,0.366,501,1082,0.463,0.474,219,291,0.753,118,291,409,158,54,52,195,222,1401
471,Michael Beasley,4,SF,47,7,1087,221,497,0.445,38,101,0.376,183,396,0.462,0.483,61,95,0.642,39,168,207,45,18,19,80,83,541
472,O.J. Mayo,1,SG,82,82,3120,562,1283,0.438,145,378,0.384,417,905,0.461,0.495,247,281,0.879,56,252,308,262,91,13,226,204,1516
472,O.J. Mayo,2,SG,82,82,3113,542,1183,0.458,136,355,0.383,406,828,0.49,0.516,212,262,0.809,61,250,311,242,98,17,176,174,1432
472,O.J. Mayo,3,SG,71,17,1869,304,747,0.407,96,264,0.364,208,483,0.431,0.471,99,131,0.756,35,135,170,145,73,26,99,127,803
472,O.J. Mayo,4,SG,66,0,1771,300,736,0.408,100,275,0.364,200,461,0.434,0.476,133,172,0.773,30,180,210,169,71,23,124,137,833
473,Russell Westbrook,1,PG,82,65,2668,436,1095,0.398,35,129,0.271,401,966,0.415,0.414,349,428,0.815,178,221,399,435,110,16,274,191,1256
473,Russell Westbrook,2,PG,82,82,2813,485,1160,0.418,23,104,0.221,462,1056,0.438,0.428,329,422,0.78,143,258,401,652,108,34,268,204,1322
473,Russell Westbrook,3,PG,82,82,2847,614,1390,0.442,34,103,0.33,580,1287,0.451,0.454,531,631,0.842,121,258,379,670,155,30,316,207,1793
473,Russell Westbrook,4,PG,66,66,2331,578,1266,0.457,62,196,0.316,516,1070,0.482,0.481,340,413,0.823,96,205,301,362,112,21,239,147,1558
474,Kevin Love,1,C,81,37,2048,316,688,0.459,2,19,0.105,314,669,0.469,0.461,265,336,0.789,274,460,734,84,35,50,118,205,899
474,Kevin Love,2,PF,60,22,1714,291,646,0.45,35,106,0.33,256,540,0.474,0.478,225,276,0.815,227,431,658,136,43,23,117,136,842
474,Kevin Love,3,PF,73,73,2611,482,1026,0.47,88,211,0.417,394,815,0.483,0.513,424,499,0.85,330,782,1112,184,45,28,155,148,1476
474,Kevin Love,4,PF,55,55,2145,474,1059,0.448,105,282,0.372,369,777,0.475,0.497,379,460,0.824,226,508,734,111,47,28,128,152,1432
475,Danilo Gallinari,1,SG,28,2,412,56,125,0.448,32,72,0.444,24,53,0.453,0.576,26,27,0.963,13,42,55,15,14,4,15,48,170
475,Danilo Gallinari,2,SF,81,74,2747,392,927,0.423,186,488,0.381,206,439,0.469,0.523,251,307,0.818,65,333,398,135,75,58,110,191,1221
475,Danilo Gallinari,3,PF-SF,62,60,2104,265,640,0.414,103,293,0.352,162,347,0.467,0.495,337,391,0.862,59,246,305,104,51,27,83,144,970
475,Danilo Gallinari,4,PF,48,48,1671,211,509,0.415,83,239,0.347,128,270,0.474,0.496,259,290,0.893,48,181,229,82,38,18,58,117,764
476,Eric Gordon,1,SG,78,65,2677,411,901,0.456,131,337,0.389,280,564,0.496,0.529,299,350,0.854,45,156,201,215,78,35,164,172,1252
476,Eric Gordon,2,SG,62,60,2229,352,784,0.449,119,321,0.371,233,463,0.503,0.525,222,299,0.742,25,135,160,186,69,14,144,96,1045
476,Eric Gordon,3,SG,56,56,2112,427,949,0.45,106,291,0.364,321,658,0.488,0.506,287,348,0.825,45,119,164,244,71,18,151,115,1247
476,Eric Gordon,4,PG,9,9,310,63,140,0.45,10,40,0.25,53,100,0.53,0.486,49,65,0.754,2,23,25,31,13,4,24,20,185
477,Joe Alexander,1,SF,59,0,716,102,245,0.416,16,46,0.348,86,199,0.432,0.449,58,83,0.699,44,71,115,42,15,29,52,107,278
477,Joe Alexander,2,SF,8,0,29,1,6,0.167,0,1,0,1,5,0.2,0.167,2,3,0.667,2,3,5,2,1,1,0,9,4
478,D.J. Augustin,1,PG,72,12,1908,267,621,0.43,108,246,0.439,159,375,0.424,0.517,208,233,0.893,17,116,133,250,42,2,119,140,850
478,D.J. Augustin,2,PG,80,2,1472,168,435,0.386,70,178,0.393,98,257,0.381,0.467,102,131,0.779,11,86,97,193,45,5,74,127,508
478,D.J. Augustin,3,PG,82,82,2757,399,958,0.416,111,333,0.333,288,625,0.461,0.474,269,297,0.906,38,187,225,498,54,3,155,152,1178
478,D.J. Augustin,4,PG,48,46,1408,183,487,0.376,61,179,0.341,122,308,0.396,0.438,105,120,0.875,24,85,109,307,36,1,110,65,532
479,Brook Lopez,1,C,82,75,2501,448,844,0.531,0,2,0,448,842,0.532,0.531,172,217,0.793,225,440,665,86,44,151,147,257,1068
479,Brook Lopez,2,C,82,82,3027,563,1129,0.499,0,2,0,563,1127,0.5,0.499,416,509,0.817,270,439,709,187,55,139,204,251,1542
479,Brook Lopez,3,C,82,82,2889,644,1309,0.492,0,1,0,644,1308,0.492,0.492,385,489,0.787,197,291,488,129,47,120,176,240,1673
479,Brook Lopez,4,C,5,5,136,38,77,0.494,0,0,,38,77,0.494,0.494,20,32,0.625,8,10,18,6,1,4,6,8,96
480,Jerryd Bayless,1,PG,53,0,655,69,189,0.365,7,27,0.259,62,162,0.383,0.384,83,103,0.806,8,49,57,78,16,2,56,81,228
480,Jerryd Bayless,2,SG,74,11,1304,200,483,0.414,29,92,0.315,171,391,0.437,0.444,201,242,0.831,18,102,120,172,26,5,94,152,630
480,Jerryd Bayless,3,PG,71,14,1496,218,517,0.422,49,146,0.336,169,371,0.456,0.469,166,206,0.806,26,139,165,266,38,5,127,149,651
480,Jerryd Bayless,4,PG,11,0,149,17,49,0.347,3,14,0.214,14,35,0.4,0.378,13,17,0.765,2,13,15,28,2,1,17,16,50
481,Jason Thompson,1,PF,82,56,2303,356,717,0.497,0,8,0,356,709,0.502,0.497,198,286,0.692,234,372,606,93,46,59,146,314,910
481,Jason Thompson,2,C,75,58,2357,370,784,0.472,1,10,0.1,369,774,0.477,0.473,198,277,0.715,224,413,637,124,41,73,139,279,939
481,Jason Thompson,3,PF,75,39,1748,271,534,0.507,0,3,0,271,531,0.51,0.507,121,200,0.605,144,310,454,88,28,44,99,212,663
481,Jason Thompson,4,PF,64,47,1657,237,443,0.535,0,2,0,237,441,0.537,0.535,109,181,0.602,166,277,443,79,43,44,68,149,583
482,Brandon Rush,1,SG,75,19,1803,243,575,0.423,78,209,0.373,165,366,0.451,0.49,46,66,0.697,34,199,233,66,38,37,75,128,610
482,Brandon Rush,2,SG,82,64,2491,297,702,0.423,124,302,0.411,173,400,0.433,0.511,56,89,0.629,41,305,346,112,56,65,93,159,774
482,Brandon Rush,3,SG,67,21,1754,217,515,0.421,93,223,0.417,124,292,0.425,0.512,80,106,0.755,33,184,217,62,41,35,69,107,607
482,Brandon Rush,4,SF,65,1,1717,235,469,0.501,99,219,0.452,136,250,0.544,0.607,65,82,0.793,33,218,251,88,35,58,68,64,634
483,Anthony Randolph,1,PF,63,22,1129,199,431,0.462,0,4,0,199,427,0.466,0.462,101,141,0.716,128,235,363,49,42,74,80,141,499
483,Anthony Randolph,2,C,33,8,749,137,309,0.443,1,5,0.2,136,304,0.447,0.445,109,136,0.801,73,142,215,42,28,51,49,92,384
483,Anthony Randolph,3,C-PF,40,3,590,123,264,0.466,1,4,0.25,122,260,0.469,0.468,58,86,0.674,43,117,160,33,22,24,53,62,305
483,Anthony Randolph,4,PF,17,0,127,14,45,0.311,1,4,0.25,13,41,0.317,0.322,6,12,0.5,11,29,40,7,4,8,10,15,35
484,Robin Lopez,1,C,60,7,614,71,137,0.518,0,1,0,71,136,0.522,0.518,47,68,0.691,52,66,118,8,11,41,28,97,189
484,Robin Lopez,2,C,51,31,986,171,291,0.588,0,0,,171,291,0.588,0.588,88,125,0.704,104,144,248,7,10,53,41,117,430
484,Robin Lopez,3,C,67,56,991,179,357,0.501,0,0,,179,357,0.501,0.501,74,100,0.74,82,134,216,8,18,45,48,143,432
484,Robin Lopez,4,C,64,0,895,124,269,0.461,0,0,,124,269,0.461,0.461,100,140,0.714,90,119,209,20,18,60,43,128,348
485,Marreese Speights,1,C,79,2,1263,252,502,0.502,2,8,0.25,250,494,0.506,0.504,102,132,0.773,123,170,293,30,27,56,46,181,608
485,Marreese Speights,2,C,62,1,1016,212,444,0.477,0,5,0,212,439,0.483,0.477,108,145,0.745,85,167,252,36,29,34,51,152,532
485,Marreese Speights,3,C,64,1,734,144,291,0.495,1,4,0.25,143,287,0.498,0.497,55,73,0.753,64,146,210,30,8,19,40,120,344
485,Marreese Speights,4,PF,60,54,1345,221,488,0.453,0,3,0,221,485,0.456,0.453,84,109,0.771,133,241,374,48,21,29,74,147,526
486,Roy Hibbert,1,C,70,42,1009,198,420,0.471,0,0,,198,420,0.471,0.471,98,147,0.667,115,128,243,49,20,76,55,215,494
486,Roy Hibbert,2,C,81,69,2035,387,782,0.495,3,6,0.5,384,776,0.495,0.497,169,224,0.754,177,287,464,158,30,131,145,285,946
486,Roy Hibbert,3,C,81,80,2244,410,890,0.461,0,4,0,410,886,0.463,0.461,205,275,0.745,182,428,610,166,33,142,185,256,1025
486,Roy Hibbert,4,C,65,65,1937,332,668,0.497,0,1,0,332,667,0.498,0.497,170,239,0.711,213,359,572,108,32,128,128,195,834
487,JaVale McGee,1,C,75,14,1143,191,387,0.494,0,0,,191,387,0.494,0.494,107,162,0.66,120,174,294,23,33,75,61,155,489
487,JaVale McGee,2,C,60,19,968,156,307,0.508,0,1,0,156,306,0.51,0.508,74,116,0.638,88,155,243,14,16,101,51,122,386
487,JaVale McGee,3,C,79,75,2193,332,604,0.55,0,3,0,332,601,0.552,0.55,134,230,0.583,223,411,634,38,41,193,102,232,798
487,JaVale McGee,4,C,61,45,1535,307,552,0.556,0,0,,307,552,0.556,0.556,77,167,0.461,163,314,477,31,35,132,87,166,691
488,J.J. Hickson,1,C,62,0,705,100,194,0.515,0,0,,100,194,0.515,0.515,45,67,0.672,52,113,165,9,14,30,45,81,245
488,J.J. Hickson,2,PF,81,73,1691,289,522,0.554,0,1,0,289,521,0.555,0.554,111,163,0.681,110,290,400,40,36,39,92,132,689
488,J.J. Hickson,3,C,80,66,2256,429,936,0.458,0,5,0,429,931,0.461,0.458,247,367,0.673,217,478,695,91,48,54,173,215,1105
488,J.J. Hickson,4,PF,54,19,1244,183,392,0.467,0,2,0,183,390,0.469,0.467,86,134,0.642,133,202,335,45,30,35,70,85,452
489,Alexis Ajinca,1,PF,31,4,182,25,69,0.362,0,2,0,25,67,0.373,0.362,20,28,0.714,9,21,30,3,7,6,12,34,70
489,Alexis Ajinca,2,C,6,0,30,5,10,0.5,0,0,,5,10,0.5,0.5,0,1,0,1,3,4,0,1,1,2,5,10
489,Alexis Ajinca,3,C,34,2,340,59,133,0.444,12,34,0.353,47,99,0.475,0.489,13,18,0.722,17,61,78,10,11,19,18,73,143
489,Alexis Ajinca,4,C,10,2,75,12,32,0.375,3,7,0.429,9,25,0.36,0.422,2,3,0.667,5,12,17,2,3,5,1,13,29
490,Ryan Anderson,1,PF,66,30,1312,160,407,0.393,69,189,0.365,91,218,0.417,0.478,98,116,0.845,104,207,311,52,44,20,63,157,487
490,Ryan Anderson,2,PF,63,6,911,169,388,0.436,78,211,0.37,91,177,0.514,0.536,71,82,0.866,70,132,202,37,25,14,56,81,487
490,Ryan Anderson,3,PF,64,14,1424,226,525,0.43,134,341,0.393,92,184,0.5,0.558,95,117,0.812,129,226,355,52,30,38,49,137,681
490,Ryan Anderson,4,PF,61,61,1964,332,757,0.439,166,422,0.393,166,335,0.496,0.548,150,171,0.877,224,247,471,54,50,26,57,146,980
491,Courtney Lee,1,SG,77,42,1939,243,540,0.45,82,203,0.404,161,337,0.478,0.526,78,94,0.83,18,160,178,91,76,14,69,157,646
491,Courtney Lee,2,SG,71,66,2375,338,775,0.436,76,225,0.338,262,550,0.476,0.485,133,153,0.869,60,192,252,121,93,20,76,130,885
491,Courtney Lee,3,SG,81,1,1723,253,576,0.439,71,174,0.408,182,402,0.453,0.501,95,120,0.792,51,158,209,100,58,18,68,102,672
491,Courtney Lee,4,SG,58,26,1757,251,580,0.433,87,217,0.401,164,363,0.452,0.508,71,86,0.826,26,133,159,88,68,22,64,106,660
492,Kosta Koufos,1,C,48,7,565,94,185,0.508,0,0,,94,185,0.508,0.508,36,51,0.706,50,88,138,20,12,31,26,70,224
492,Kosta Koufos,2,C,36,0,172,22,47,0.468,0,0,,22,47,0.468,0.468,9,15,0.6,16,29,45,6,2,4,15,26,53
492,Kosta Koufos,3,C,50,2,434,68,150,0.453,0,2,0,68,148,0.459,0.453,24,43,0.558,57,73,130,7,10,25,31,59,160
492,Kosta Koufos,4,C,39,1,336,47,108,0.435,0,2,0,47,106,0.443,0.435,12,24,0.5,42,55,97,7,8,20,25,50,106
493,Serge Ibaka,1,PF,73,0,1323,201,370,0.543,1,2,0.5,200,368,0.543,0.545,58,92,0.63,138,259,397,10,25,97,68,194,461
493,Serge Ibaka,2,PF,82,44,2216,335,617,0.543,0,1,0,335,616,0.544,0.543,138,184,0.75,214,408,622,22,31,198,71,267,808
493,Serge Ibaka,3,PF,66,66,1792,262,490,0.535,1,3,0.333,261,487,0.536,0.536,78,118,0.661,193,305,498,28,33,241,79,179,603
493,Serge Ibaka,4,PF,80,80,2486,446,778,0.573,20,57,0.351,426,721,0.591,0.586,143,191,0.749,222,395,617,43,28,242,125,213,1055
494,Nicolas Batum,1,SF,79,76,1454,161,361,0.446,62,168,0.369,99,193,0.513,0.532,42,52,0.808,84,136,220,74,50,40,50,139,426
494,Nicolas Batum,2,SF,37,25,918,139,268,0.519,54,132,0.409,85,136,0.625,0.619,43,51,0.843,32,109,141,44,24,25,27,83,375
494,Nicolas Batum,3,SF,80,67,2522,367,807,0.455,118,342,0.345,249,465,0.535,0.528,138,164,0.841,109,252,361,123,68,49,83,194,990
494,Nicolas Batum,4,SF,59,34,1791,289,641,0.451,107,274,0.391,182,367,0.496,0.534,133,159,0.836,81,190,271,84,57,60,90,105,818
495,George Hill,1,PG,77,7,1270,150,372,0.403,24,73,0.329,126,299,0.421,0.435,114,146,0.781,30,128,158,136,45,21,74,150,438
495,George Hill,2,PG,78,43,2276,353,738,0.478,75,188,0.399,278,550,0.505,0.529,183,237,0.772,42,163,205,226,69,26,101,222,964
495,George Hill,3,PG,76,5,2148,287,633,0.453,77,204,0.377,210,429,0.49,0.514,233,270,0.863,24,175,199,193,66,21,99,153,884
495,George Hill,4,PG,50,9,1274,168,380,0.442,54,147,0.367,114,233,0.489,0.513,91,117,0.778,31,120,151,145,42,17,52,98,481
496,Darrell Arthur,1,PF,76,64,1464,191,436,0.438,0,2,0,191,434,0.44,0.438,40,60,0.667,108,238,346,43,52,52,47,206,422
496,Darrell Arthur,2,PF,32,1,457,63,146,0.432,0,1,0,63,145,0.434,0.432,17,30,0.567,37,73,110,15,14,14,22,60,143
496,Darrell Arthur,3,PF,80,9,1609,310,624,0.497,0,6,0,310,618,0.502,0.497,109,134,0.813,115,227,342,53,52,63,88,228,729
496,Darrell Arthur,4,PF,59,3,970,162,359,0.451,5,18,0.278,157,341,0.46,0.458,33,46,0.717,68,101,169,33,24,33,43,126,362
497,Donte Greene,1,SF,55,4,725,77,236,0.326,26,100,0.26,51,136,0.375,0.381,29,34,0.853,19,67,86,30,16,14,37,68,209
497,Donte Greene,2,SF,76,50,1630,244,553,0.441,69,183,0.377,175,370,0.473,0.504,90,140,0.643,53,181,234,71,41,53,93,150,647
497,Donte Greene,3,SF,69,21,1127,156,386,0.404,45,154,0.292,111,232,0.478,0.462,43,65,0.662,49,98,147,48,36,20,60,88,400
497,Donte Greene,4,PF,53,7,777,108,266,0.406,25,105,0.238,83,161,0.516,0.453,44,55,0.8,19,114,133,34,18,29,32,67,285
498,D.J. White,1,PF,7,0,130,26,50,0.52,0,0,,26,50,0.52,0.52,10,13,0.769,10,22,32,6,3,5,3,10,62
498,D.J. White,2,PF,12,0,102,25,41,0.61,0,0,,25,41,0.61,0.61,9,10,0.9,10,13,23,4,5,3,3,12,59
498,D.J. White,3,C-PF,47,0,685,111,219,0.507,0,2,0,111,217,0.512,0.507,46,64,0.719,43,115,158,19,12,20,14,77,268
498,D.J. White,4,PF,23,0,219,30,65,0.462,0,0,,30,65,0.462,0.462,5,10,0.5,12,40,52,4,6,8,7,31,65
499,J.R. Giddens,1,SF,6,0,8,2,3,0.667,0,0,,2,3,0.667,0.667,0,0,,2,1,3,0,1,0,1,1,4
499,J.R. Giddens,2,SF,32,1,239,28,60,0.467,0,10,0,28,50,0.56,0.467,13,23,0.565,16,35,51,13,9,2,17,29,69
499,J.R. Giddens,3,SF,21,1,99,9,21,0.429,0,2,0,9,19,0.474,0.429,6,12,0.5,4,16,20,6,4,1,7,10,24
499,J.R. Giddens,4,SF,11,0,140,19,39,0.487,0,8,0,19,31,0.613,0.487,7,11,0.636,12,19,31,7,5,1,10,19,45
500,Nikola Pekovic,1,C,65,11,887,136,263,0.517,0,0,,136,263,0.517,0.517,87,114,0.763,90,103,193,27,18,35,91,181,359
500,Nikola Pekovic,2,C,47,35,1264,256,454,0.564,0,0,,256,454,0.564,0.564,139,187,0.743,181,165,346,31,29,31,87,98,651
500,Nikola Pekovic,3,C,62,62,1959,385,741,0.52,0,0,,385,741,0.52,0.52,241,324,0.744,230,315,545,53,43,50,101,143,1011
500,Nikola Pekovic,4,C,54,54,1663,379,701,0.541,0,0,,379,701,0.541,0.541,186,249,0.747,206,262,468,50,30,23,84,129,944
501,Walter Sharpe,1,PF,8,0,20,4,11,0.364,0,2,0,4,9,0.444,0.364,0,2,0,0,3,3,0,0,2,0,3,8
502,Joey Dorsey,1,PF,3,0,6,1,2,0.5,0,0,,1,2,0.5,0.5,0,0,,0,1,1,1,0,0,0,0,2
502,Joey Dorsey,2,PF,15,0,106,9,20,0.45,0,0,,9,20,0.45,0.45,5,12,0.417,16,27,43,2,3,2,6,21,23
502,Joey Dorsey,3,PF,7,0,54,5,11,0.455,0,0,,5,11,0.455,0.455,1,2,0.5,11,14,25,2,2,1,4,12,11
502,Joey Dorsey,4,PF,8,0,52,4,9,0.444,0,0,,4,9,0.444,0.444,4,10,0.4,5,13,18,0,1,1,2,9,12
503,Mario Chalmers,1,PG,82,82,2626,278,662,0.42,114,311,0.367,164,351,0.467,0.506,148,193,0.767,37,191,228,403,160,8,165,240,818
503,Mario Chalmers,2,PG,73,22,1807,182,454,0.401,75,236,0.318,107,218,0.491,0.483,82,110,0.745,25,110,135,246,91,12,123,175,521
503,Mario Chalmers,3,PG,70,28,1579,155,388,0.399,83,231,0.359,72,157,0.459,0.506,54,62,0.871,12,134,146,177,76,7,91,158,447
503,Mario Chalmers,4,PG,64,64,1825,223,498,0.448,101,260,0.388,122,238,0.513,0.549,80,101,0.792,16,155,171,222,97,11,142,166,627
504,DeAndre Jordan,1,C,53,13,771,93,147,0.633,0,0,,93,147,0.633,0.633,42,109,0.385,72,165,237,11,11,59,41,96,228
504,DeAndre Jordan,2,C,70,12,1137,144,238,0.605,0,2,0,144,236,0.61,0.605,48,128,0.375,122,230,352,21,16,62,75,152,336
504,DeAndre Jordan,3,C,80,66,2047,234,341,0.686,0,1,0,234,340,0.688,0.686,98,217,0.452,207,368,575,42,41,142,101,255,566
504,DeAndre Jordan,4,C,66,66,1798,206,326,0.632,0,1,0,206,325,0.634,0.632,74,141,0.525,202,344,546,17,30,134,74,189,486
505,Omer Asik,1,C,82,0,989,78,141,0.553,0,0,,78,141,0.553,0.553,73,145,0.503,112,194,306,32,20,56,64,153,229
505,Omer Asik,2,C,66,2,971,79,156,0.506,0,0,,79,156,0.506,0.506,47,103,0.456,127,223,350,32,30,68,68,121,205
505,Omer Asik,3,C,82,82,2464,332,614,0.541,0,1,0,332,613,0.542,0.541,168,299,0.562,275,681,956,75,46,87,173,223,832
505,Omer Asik,4,C,48,19,968,101,190,0.532,0,0,,101,190,0.532,0.532,78,126,0.619,101,277,378,25,14,37,59,92,280
506,Luc Mbah a Moute,1,PF,82,52,2114,227,491,0.462,0,4,0,227,487,0.466,0.462,140,192,0.729,189,298,487,87,87,45,100,204,594
506,Luc Mbah a Moute,2,PF,73,62,1866,177,369,0.48,6,17,0.353,171,352,0.486,0.488,93,133,0.699,171,229,400,81,60,39,70,181,453
506,Luc Mbah a Moute,3,PF,79,52,2093,198,428,0.463,0,7,0,198,421,0.47,0.463,133,188,0.707,169,251,420,68,72,28,77,180,529
506,Luc Mbah a Moute,4,PF,43,22,1009,133,261,0.51,1,4,0.25,132,257,0.514,0.511,66,103,0.641,77,150,227,29,40,22,39,93,333
507,Kyle Weaver,1,SG,56,19,1166,113,246,0.459,32,93,0.344,81,153,0.529,0.524,41,58,0.707,31,99,130,101,47,25,69,81,299
507,Kyle Weaver,2,SG,12,0,144,12,33,0.364,7,19,0.368,5,14,0.357,0.47,5,6,0.833,1,17,18,11,6,6,4,13,36
507,Kyle Weaver,3,SG,5,0,69,9,25,0.36,3,7,0.429,6,18,0.333,0.42,7,8,0.875,2,8,10,7,2,2,7,3,28
508,Sonny Weems,1,SG,12,0,55,8,25,0.32,0,3,0,8,22,0.364,0.32,3,8,0.375,0,4,4,3,1,0,6,8,19
508,Sonny Weems,2,SG,69,19,1368,236,458,0.515,2,15,0.133,234,443,0.528,0.517,44,64,0.688,42,150,192,101,39,25,65,126,518
508,Sonny Weems,3,SF,59,28,1413,228,513,0.444,17,61,0.279,211,452,0.467,0.461,72,94,0.766,39,114,153,104,34,2,86,87,545
508,Sonny Weems,4,SG-SF,43,0,499,42,110,0.382,15,41,0.366,27,69,0.391,0.45,8,15,0.533,7,46,53,49,10,1,41,47,107
509,Chris Douglas-Roberts,1,SG,44,3,585,81,176,0.46,3,12,0.25,78,164,0.476,0.469,51,62,0.823,14,36,50,52,12,7,31,34,216
509,Chris Douglas-Roberts,2,SF,67,38,1730,255,573,0.445,14,54,0.259,241,519,0.464,0.457,133,157,0.847,45,153,198,93,55,19,97,101,657
509,Chris Douglas-Roberts,3,SF,44,12,884,117,273,0.429,15,46,0.326,102,227,0.449,0.456,74,89,0.831,7,81,88,50,29,13,35,73,323
509,Chris Douglas-Roberts,4,SG,6,0,63,5,14,0.357,0,4,0,5,10,0.5,0.357,7,10,0.7,0,5,5,4,2,0,1,4,17
510,Nathan Jawai,1,PF,6,0,19,1,4,0.25,0,0,,1,4,0.25,0.25,0,0,,1,1,2,0,0,0,2,3,2
510,Nathan Jawai,2,C,39,2,412,49,111,0.441,0,1,0,49,110,0.445,0.441,26,38,0.684,49,55,104,24,10,9,27,58,124
511,Sean Singletary,1,PG,37,2,303,31,85,0.365,10,25,0.4,21,60,0.35,0.424,18,21,0.857,10,25,35,29,11,0,23,45,90
511,Sean Singletary,2,PG,13,1,122,12,37,0.324,4,10,0.4,8,27,0.296,0.378,6,6,1,5,11,16,12,6,0,5,14,34
511,Sean Singletary,3,PG,24,1,181,19,48,0.396,6,15,0.4,13,33,0.394,0.458,12,15,0.8,5,14,19,17,5,0,18,31,56
512,Patrick Ewing,1,SF,7,0,19,0,5,0,0,2,0,0,3,0,0,3,4,0.75,1,1,2,2,0,1,1,1,3
513,Ante Tomic,No NBA Data,,,,,,,,,,,,,,,,,,,,,,,,,,
514,Goran Dragic,1,PG,55,1,728,88,224,0.393,20,54,0.37,68,170,0.4,0.438,50,65,0.769,33,70,103,111,29,3,73,87,246
514,Goran Dragic,2,PG,80,2,1442,222,491,0.452,74,188,0.394,148,303,0.488,0.527,117,159,0.736,38,133,171,241,48,8,126,131,635
514,Goran Dragic,3,PG,70,5,1234,192,441,0.435,56,155,0.361,136,286,0.476,0.499,83,133,0.624,36,106,142,204,50,10,117,125,523
514,Goran Dragic,4,PG,48,2,856,133,316,0.421,28,101,0.277,105,215,0.488,0.465,59,97,0.608,24,62,86,149,36,6,96,90,353
515,Trent Plaisted,No NBA Data,,,,,,,,,,,,,,,,,,,,,,,,,,
516,Bill Walker,1,SF,29,0,216,36,58,0.621,0,1,0,36,57,0.632,0.621,16,23,0.696,8,21,29,13,6,2,18,51,88
516,Bill Walker,2,SG-SF,35,13,768,120,232,0.517,50,116,0.431,70,116,0.603,0.625,39,49,0.796,15,73,88,40,23,3,28,83,329
516,Bill Walker,3,SF,8,0,29,3,6,0.5,0,0,,3,6,0.5,0.5,2,2,1,0,5,5,3,0,0,2,4,8
516,Bill Walker,4,SG,27,13,739,117,226,0.518,50,116,0.431,67,110,0.609,0.628,37,47,0.787,15,68,83,37,23,3,26,79,321
517,Malik Hairston,1,SG,15,0,155,24,49,0.49,0,1,0,24,48,0.5,0.49,2,7,0.286,11,17,28,13,6,7,12,19,50
517,Malik Hairston,2,SG,47,0,317,40,76,0.526,2,11,0.182,38,65,0.585,0.539,17,30,0.567,13,36,49,16,4,9,11,29,99
518,Richard Hendrix,No NBA Data,,,,,,,,,,,,,,,,,,,,,,,,,,
519,DeVon Hardin,No NBA Data,,,,,,,,,,,,,,,,,,,,,,,,,,
520,Shan Foster,No NBA Data,,,,,,,,,,,,,,,,,,,,,,,,,,
521,Darnell Jackson,1,PF,51,2,430,37,86,0.43,0,2,0,37,84,0.44,0.43,24,35,0.686,32,55,87,8,10,4,14,77,98
521,Darnell Jackson,2,PF,28,0,123,9,30,0.3,1,4,0.25,8,26,0.308,0.317,4,6,0.667,9,13,22,4,2,4,13,21,23
521,Darnell Jackson,3,PF,27,0,114,8,25,0.32,1,3,0.333,7,22,0.318,0.34,4,6,0.667,8,12,20,4,2,4,13,19,21
521,Darnell Jackson,4,PF,1,0,9,1,5,0.2,0,1,0,1,4,0.25,0.2,0,0,,1,1,2,0,0,0,0,2,2
522,Tadija Dragicevic,No NBA Data,,,,,,,,,,,,,,,,,,,,,,,,,,
523,Maarty Leunen,No NBA Data,,,,,,,,,,,,,,,,,,,,,,,,,,
524,Mike Taylor,1,PG,51,5,771,110,267,0.412,13,40,0.325,97,227,0.427,0.436,56,81,0.691,22,65,87,106,36,0,73,84,289
525,Sasha Kaun,1,C,25,0,95,9,17,0.529,0,0,,9,17,0.529,0.529,5,11,0.455,12,14,26,3,4,5,7,11,23
526,James Gist,No NBA Data,,,,,,,,,,,,,,,,,,,,,,,,,,
527,Joe Crawford,1,SF,2,0,23,3,10,0.3,1,4,0.25,2,6,0.333,0.35,2,2,1,1,3,4,1,1,0,0,2,9
528,Deron Washington,No NBA Data,,,,,,,,,,,,,,,,,,,,,,,,,,
529,Semih Erden,1,C,41,8,595,62,111,0.559,0,0,,62,111,0.559,0.559,39,60,0.65,37,81,118,20,15,24,34,104,163
529,Semih Erden,2,C,37,7,531,58,97,0.598,0,0,,58,97,0.598,0.598,34,54,0.63,31,76,107,19,13,21,32,92,150
529,Semih Erden,3,C,4,1,64,4,14,0.286,0,0,,4,14,0.286,0.286,5,6,0.833,6,5,11,1,2,3,2,12,13
529,Semih Erden,4,C,28,9,333,39,74,0.527,0,0,,39,74,0.527,0.527,21,41,0.512,20,52,72,9,10,5,16,60,99
530,Blake Griffin,1,PF,82,82,3112,696,1376,0.506,7,24,0.292,689,1352,0.51,0.508,446,695,0.642,270,719,989,312,63,45,223,252,1845
530,Blake Griffin,2,PF,66,66,2392,561,1022,0.549,2,16,0.125,559,1006,0.556,0.55,244,468,0.521,218,499,717,210,54,48,150,216,1368
530,Blake Griffin,3,PF,80,80,2598,577,1072,0.538,5,28,0.179,572,1044,0.548,0.541,281,426,0.66,186,476,662,299,97,50,185,231,1440
530,Blake Griffin,4,PF,80,80,2863,718,1359,0.528,12,44,0.273,706,1315,0.537,0.533,482,674,0.715,192,565,757,309,92,51,224,265,1930
531,Hasheem Thabeet,1,C,68,13,883,77,131,0.588,0,0,,77,131,0.588,0.588,54,93,0.581,85,158,243,11,15,89,43,162,208
531,Hasheem Thabeet,2,C,47,0,373,17,40,0.425,0,0,,17,40,0.425,0.425,19,35,0.543,24,51,75,4,9,16,17,76,53
531,Hasheem Thabeet,3,C,45,0,369,17,39,0.436,0,0,,17,39,0.436,0.436,19,35,0.543,24,51,75,4,9,15,17,73,53
531,Hasheem Thabeet,4,C,2,0,4,0,1,0,0,0,,0,1,0,0,0,0,,0,0,0,0,0,1,0,3,0
532,James Harden,1,SG,76,0,1738,233,578,0.403,93,248,0.375,140,330,0.424,0.484,194,240,0.808,47,197,244,137,80,20,106,200,753
532,James Harden,2,SG,82,5,2189,298,684,0.436,113,324,0.349,185,360,0.514,0.518,289,343,0.843,42,213,255,176,92,24,106,207,998
532,James Harden,3,SG,62,2,1946,309,629,0.491,114,292,0.39,195,337,0.579,0.582,312,369,0.846,30,222,252,229,62,15,137,150,1044
532,James Harden,4,SG,78,78,2985,585,1337,0.438,179,486,0.368,406,851,0.477,0.504,674,792,0.851,62,317,379,455,142,38,295,178,2023
533,Tyreke Evans,1,SG,72,72,2677,533,1165,0.458,36,141,0.255,497,1024,0.485,0.473,348,465,0.748,66,314,380,414,109,26,216,204,1450
533,Tyreke Evans,2,SG,57,53,2107,382,933,0.409,43,148,0.291,339,785,0.432,0.432,205,266,0.771,46,229,275,319,85,30,184,143,1012
533,Tyreke Evans,3,SG,63,61,2162,408,900,0.453,20,99,0.202,388,801,0.484,0.464,201,258,0.779,64,225,289,283,84,29,171,136,1037
533,Tyreke Evans,4,SG,65,61,2016,366,765,0.478,45,133,0.338,321,632,0.508,0.508,210,271,0.775,56,231,287,229,90,27,128,133,987
534,Ricky Rubio,1,PG,41,31,1404,139,389,0.357,32,94,0.34,107,295,0.363,0.398,126,157,0.803,21,150,171,336,91,8,131,97,436
534,Ricky Rubio,2,PG,57,47,1691,185,514,0.36,27,92,0.293,158,422,0.374,0.386,211,264,0.799,44,185,229,418,137,5,172,143,608
534,Ricky Rubio,3,PG,82,82,2638,255,670,0.381,44,133,0.331,211,537,0.393,0.413,227,283,0.802,61,281,342,704,191,11,221,218,781
534,Ricky Rubio,4,PG,22,22,692,78,219,0.356,13,51,0.255,65,168,0.387,0.386,57,71,0.803,19,106,125,193,38,1,64,59,226
535,Jonny Flynn,1,PG,81,81,2339,397,952,0.417,77,215,0.358,320,737,0.434,0.457,223,270,0.826,24,167,191,356,82,2,233,98,1094
535,Jonny Flynn,2,PG,53,8,983,108,296,0.365,31,100,0.31,77,196,0.393,0.417,32,42,0.762,12,65,77,182,34,3,113,58,279
535,Jonny Flynn,3,PG,29,1,416,46,131,0.351,10,34,0.294,36,97,0.371,0.389,29,39,0.744,8,31,39,96,6,2,36,23,131
535,Jonny Flynn,4,PG,11,0,135,12,41,0.293,2,9,0.222,10,32,0.313,0.317,11,14,0.786,1,7,8,28,3,1,9,8,37
536,Stephen Curry,1,PG,80,77,2896,528,1143,0.462,166,380,0.437,362,763,0.474,0.535,177,200,0.885,48,308,356,472,152,19,243,252,1399
536,Stephen Curry,2,PG,74,74,2489,505,1053,0.48,151,342,0.442,354,711,0.498,0.551,212,227,0.934,52,234,286,432,109,20,226,233,1373
536,Stephen Curry,3,PG,26,23,732,145,296,0.49,55,121,0.455,90,175,0.514,0.583,38,47,0.809,15,73,88,138,39,8,65,62,383
536,Stephen Curry,4,PG,78,78,2983,626,1388,0.451,272,600,0.453,354,788,0.449,0.549,262,291,0.9,59,255,314,539,126,12,240,198,1786
537,Jordan Hill,1,PF,47,0,624,99,201,0.493,0,2,0,99,199,0.497,0.493,46,68,0.676,76,99,175,20,14,21,30,92,244
537,Jordan Hill,2,PF,24,0,252,41,92,0.446,0,2,0,41,90,0.456,0.446,15,21,0.714,32,29,61,7,10,9,12,37,97
537,Jordan Hill,3,PF,23,0,372,58,109,0.532,0,0,,58,109,0.532,0.532,31,47,0.66,44,70,114,13,4,12,18,55,147
537,Jordan Hill,4,C,72,11,1125,173,352,0.491,0,2,0,173,350,0.494,0.491,60,85,0.706,128,178,306,29,14,52,62,157,406
538,DeMar DeRozan,1,SG,77,65,1664,255,512,0.498,4,16,0.25,251,496,0.506,0.502,148,194,0.763,66,157,223,53,43,18,62,176,662
538,DeMar DeRozan,2,SG,82,82,2851,539,1154,0.467,5,52,0.096,534,1102,0.485,0.469,327,402,0.813,75,240,315,148,85,31,144,217,1410
538,DeMar DeRozan,3,SG,63,63,2206,381,903,0.422,24,92,0.261,357,811,0.44,0.435,268,331,0.81,40,171,211,128,48,17,123,162,1054
538,DeMar DeRozan,4,SG,82,82,3013,548,1231,0.445,34,120,0.283,514,1111,0.463,0.459,355,427,0.831,48,272,320,204,76,24,151,173,1485
539,Brandon Jennings,1,PG,82,82,2671,451,1216,0.371,145,388,0.374,306,828,0.37,0.431,223,273,0.817,49,233,282,470,105,18,200,191,1270
539,Brandon Jennings,2,PG,63,61,2169,361,926,0.39,98,303,0.323,263,623,0.422,0.443,199,246,0.809,42,192,234,305,95,21,146,131,1019
539,Brandon Jennings,3,PG,66,66,2331,469,1121,0.418,129,388,0.332,340,733,0.464,0.476,193,239,0.808,49,177,226,365,104,22,146,114,1260
539,Brandon Jennings,4,PG,80,80,2897,497,1247,0.399,173,461,0.375,324,786,0.412,0.468,230,281,0.819,59,187,246,521,125,10,203,155,1397
540,Terrence Williams,1,SF,78,9,1764,261,651,0.401,31,100,0.31,230,551,0.417,0.425,103,144,0.715,46,302,348,223,43,10,124,126,656
540,Terrence Williams,2,SG,21,0,290,43,115,0.374,6,22,0.273,37,93,0.398,0.4,14,21,0.667,4,47,51,38,9,0,33,25,106
540,Terrence Williams,3,SG,10,0,206,29,73,0.397,4,12,0.333,25,61,0.41,0.425,5,10,0.5,3,33,36,31,5,0,25,21,67
540,Terrence Williams,4,SG,11,0,84,14,42,0.333,2,10,0.2,12,32,0.375,0.357,9,11,0.818,1,14,15,7,4,0,8,4,39
541,Gerald Henderson,1,SG,43,0,355,37,104,0.356,4,19,0.211,33,85,0.388,0.375,35,47,0.745,15,40,55,13,10,9,14,25,113
541,Gerald Henderson,2,SG,68,30,1661,259,570,0.454,7,36,0.194,252,534,0.472,0.461,128,163,0.785,49,158,207,101,50,32,64,118,653
541,Gerald Henderson,3,SG,55,55,1831,332,723,0.459,11,47,0.234,321,676,0.475,0.467,155,204,0.76,64,161,225,126,49,20,100,128,830
541,Gerald Henderson,4,SG,68,58,2133,382,855,0.447,33,100,0.33,349,755,0.462,0.466,258,313,0.824,55,195,250,177,68,34,108,149,1055
542,Tyler Hansbrough,1,PF,29,1,511,81,225,0.36,0,4,0,81,221,0.367,0.36,84,113,0.743,60,78,138,28,17,8,21,70,246
542,Tyler Hansbrough,2,PF,70,29,1535,285,613,0.465,0,2,0,285,611,0.466,0.465,197,253,0.779,145,221,366,41,37,15,76,160,767
542,Tyler Hansbrough,3,PF,66,0,1442,194,479,0.405,0,1,0,194,478,0.406,0.405,226,278,0.813,113,177,290,30,54,9,65,159,614
542,Tyler Hansbrough,4,PF,81,8,1366,176,407,0.432,0,3,0,176,404,0.436,0.432,216,300,0.72,161,212,373,36,29,18,78,152,568
543,Earl Clark,1,PF,51,0,383,56,151,0.371,2,5,0.4,54,146,0.37,0.377,26,36,0.722,18,44,62,21,7,13,23,25,140
543,Earl Clark,2,SF,42,0,464,68,158,0.43,0,5,0,68,153,0.444,0.43,27,47,0.574,37,64,101,9,8,18,28,45,163
543,Earl Clark,3,SF,9,0,72,12,31,0.387,0,0,,12,31,0.387,0.387,5,10,0.5,4,13,17,4,1,3,2,6,29
543,Earl Clark,4,SF,33,0,392,56,127,0.441,0,5,0,56,122,0.459,0.441,22,37,0.595,33,51,84,5,7,15,26,39,134
544,Austin Daye,1,SF,69,4,915,137,295,0.464,29,95,0.305,108,200,0.54,0.514,46,56,0.821,34,140,174,34,25,26,48,114,349
544,Austin Daye,2,SF,72,16,1446,193,471,0.41,69,172,0.401,124,299,0.415,0.483,82,108,0.759,64,210,274,78,39,39,59,165,537
544,Austin Daye,3,SF,41,4,603,73,227,0.322,13,62,0.21,60,165,0.364,0.35,35,43,0.814,14,77,91,33,22,21,40,62,194
544,Austin Daye,4,SF,55,0,676,90,208,0.433,41,98,0.418,49,110,0.445,0.531,26,34,0.765,16,107,123,42,14,22,29,82,247
545,James Johnson,1,PF,65,11,757,95,210,0.452,15,46,0.326,80,164,0.488,0.488,51,70,0.729,34,94,128,48,21,43,62,126,256
545,James Johnson,2,SF,38,25,822,108,237,0.456,8,34,0.235,100,203,0.493,0.473,47,71,0.662,37,105,142,89,33,37,64,95,271
545,James Johnson,3,SF,13,0,123,17,41,0.415,2,9,0.222,15,32,0.469,0.439,6,13,0.462,6,18,24,14,8,9,18,25,42
545,James Johnson,4,SF,25,25,699,91,196,0.464,6,25,0.24,85,171,0.497,0.48,41,58,0.707,31,87,118,75,25,28,46,70,229
546,Jrue Holiday,1,PG,73,51,1767,230,520,0.442,62,159,0.39,168,361,0.465,0.502,65,86,0.756,56,135,191,280,79,18,156,153,587
546,Jrue Holiday,2,PG,82,82,2901,446,999,0.446,81,222,0.365,365,777,0.47,0.487,172,209,0.823,68,264,332,531,120,29,218,203,1145
546,Jrue Holiday,3,PG,65,65,2196,360,834,0.432,65,171,0.38,295,663,0.445,0.471,94,120,0.783,57,155,212,290,103,18,135,137,879
546,Jrue Holiday,4,PG,78,78,2926,555,1288,0.431,91,247,0.368,464,1041,0.446,0.466,182,242,0.752,89,240,329,625,123,32,292,170,1383
547,Ty Lawson,1,PG,65,8,1318,201,390,0.515,34,83,0.41,167,307,0.544,0.559,106,140,0.757,42,82,124,203,48,2,82,89,542
547,Ty Lawson,2,PG,80,31,2103,346,688,0.503,69,171,0.404,277,517,0.536,0.553,172,225,0.764,67,142,209,377,80,4,137,133,933
547,Ty Lawson,3,PG,61,61,2124,374,767,0.488,73,200,0.365,301,567,0.531,0.535,178,216,0.824,54,173,227,401,82,6,149,94,999
547,Ty Lawson,4,PG,73,71,2513,448,971,0.461,85,232,0.366,363,739,0.491,0.505,235,311,0.756,36,162,198,501,107,8,182,135,1216
548,Jeff Teague,1,PG,71,3,719,90,227,0.396,7,32,0.219,83,195,0.426,0.412,41,49,0.837,5,62,67,122,34,11,50,82,228
548,Jeff Teague,2,PG,70,7,963,133,304,0.438,18,48,0.375,115,256,0.449,0.467,77,97,0.794,11,91,102,138,45,25,64,82,361
548,Jeff Teague,3,PG,66,66,2183,320,672,0.476,51,149,0.342,269,523,0.514,0.514,140,185,0.757,21,138,159,321,106,37,134,145,831
548,Jeff Teague,4,PG,80,78,2628,439,974,0.451,89,248,0.359,350,726,0.482,0.496,199,226,0.881,25,155,180,579,117,28,230,181,1166
549,Eric Maynor,1,PG,81,2,1269,154,368,0.418,22,71,0.31,132,297,0.444,0.448,52,72,0.722,21,108,129,266,40,10,85,115,382
549,Eric Maynor,2,PG,26,2,363,52,133,0.391,5,24,0.208,47,109,0.431,0.41,25,33,0.758,10,28,38,81,13,2,28,33,134
549,Eric Maynor,3,PG,55,0,906,102,235,0.434,17,47,0.362,85,188,0.452,0.47,27,39,0.692,11,80,91,185,27,8,57,82,248
549,Eric Maynor,4,PG,82,0,1200,134,333,0.402,37,96,0.385,97,237,0.409,0.458,43,59,0.729,25,96,121,238,35,6,77,96,348
550,Darren Collison,1,PG,76,37,2109,376,789,0.477,46,115,0.4,330,674,0.49,0.506,148,174,0.851,41,151,192,432,78,4,202,92,946
550,Darren Collison,2,PG,79,79,2360,398,870,0.457,41,124,0.331,357,746,0.479,0.481,202,232,0.871,40,185,225,403,87,14,194,109,1039
550,Darren Collison,3,PG,60,56,1878,230,523,0.44,34,94,0.362,196,429,0.457,0.472,127,153,0.83,30,157,187,287,49,14,114,101,621
550,Darren Collison,4,PG,81,47,2372,341,724,0.471,48,136,0.353,293,588,0.498,0.504,242,275,0.88,31,188,219,415,100,8,173,139,972
551,Victor Claver,1,SF,49,16,812,74,189,0.392,25,87,0.287,49,102,0.48,0.458,14,30,0.467,31,88,119,43,26,12,43,75,187
551,Victor Claver,2,SF,21,0,184,17,42,0.405,3,18,0.167,14,24,0.583,0.44,10,11,0.909,9,30,39,12,3,3,11,16,47
551,Victor Claver,3,SF,10,0,76,9,20,0.45,6,11,0.545,3,9,0.333,0.6,0,0,,3,17,20,1,1,1,4,12,24
552,Omri Casspi,1,SF,77,31,1931,300,672,0.446,75,203,0.369,225,469,0.48,0.502,117,174,0.672,75,274,349,95,54,17,98,125,792
552,Omri Casspi,2,SF,71,27,1702,225,546,0.412,92,247,0.372,133,299,0.445,0.496,68,101,0.673,74,233,307,74,54,13,68,115,610
552,Omri Casspi,3,SF,65,35,1341,166,412,0.403,53,168,0.315,113,244,0.463,0.467,74,108,0.685,63,165,228,66,37,21,64,115,459
552,Omri Casspi,4,SF,43,1,503,63,160,0.394,25,76,0.329,38,84,0.452,0.472,22,41,0.537,20,94,114,28,25,12,22,45,173
553,Byron Mullens,1,PF,13,0,54,7,19,0.368,0,0,,7,19,0.368,0.368,0,0,,3,7,10,1,2,0,4,13,14
553,Byron Mullens,2,PF,13,0,85,9,28,0.321,0,0,,9,28,0.321,0.321,7,14,0.5,6,18,24,0,2,3,8,11,25
553,Byron Mullens,3,C,65,25,1465,251,591,0.425,12,51,0.235,239,540,0.443,0.435,92,112,0.821,96,231,327,57,21,52,74,137,606
553,Byron Mullens,4,PF,53,41,1428,217,563,0.385,66,208,0.317,151,355,0.425,0.444,64,99,0.646,71,266,337,81,34,32,74,110,564
554,Rodrigue Beaubois,1,PG,56,16,700,155,299,0.518,45,110,0.409,110,189,0.582,0.594,42,52,0.808,12,66,78,74,29,12,54,84,397
554,Rodrigue Beaubois,2,PG,28,26,496,94,223,0.422,25,83,0.301,69,140,0.493,0.478,23,30,0.767,7,45,52,64,20,8,47,76,236
554,Rodrigue Beaubois,3,PG,53,12,1151,188,445,0.422,38,132,0.288,150,313,0.479,0.465,58,69,0.841,19,132,151,152,56,28,70,98,472
554,Rodrigue Beaubois,4,PG,45,0,549,65,176,0.369,21,72,0.292,44,104,0.423,0.429,30,38,0.789,9,48,57,84,19,4,33,54,181
555,Taj Gibson,1,PF,82,70,2204,311,629,0.494,0,0,,311,629,0.494,0.494,113,175,0.646,226,385,611,70,50,104,114,282,735
555,Taj Gibson,2,PF,80,19,1742,234,502,0.466,1,8,0.125,233,494,0.472,0.467,100,148,0.676,162,296,458,58,39,106,71,203,569
555,Taj Gibson,3,PF,63,0,1284,200,404,0.495,0,0,,200,404,0.495,0.495,84,135,0.622,135,197,332,47,27,81,60,131,484
555,Taj Gibson,4,PF,65,5,1459,214,441,0.485,0,4,0,214,437,0.49,0.485,89,131,0.679,125,220,345,61,27,90,76,166,517
556,DeMarre Carroll,1,SF,71,1,795,88,222,0.396,0,6,0,88,216,0.407,0.396,33,53,0.623,53,97,150,33,28,9,24,107,209
556,DeMarre Carroll,2,PF,12,0,50,4,12,0.333,0,0,,4,12,0.333,0.333,2,2,1,2,6,8,4,1,1,0,5,10
556,DeMarre Carroll,3,PF,7,0,39,4,9,0.444,0,0,,4,9,0.444,0.444,2,2,1,2,6,8,2,1,1,0,5,10
556,DeMarre Carroll,4,PF,5,0,11,0,3,0,0,0,,0,3,0,0,0,0,,0,0,0,2,0,0,0,0,0
557,Wayne Ellington,1,SG,76,1,1384,190,448,0.424,64,162,0.395,126,286,0.441,0.496,61,70,0.871,33,126,159,74,20,5,74,72,505
557,Wayne Ellington,2,SG,62,8,1181,160,397,0.403,48,121,0.397,112,276,0.406,0.463,42,53,0.792,26,82,108,72,28,3,53,85,410
557,Wayne Ellington,3,SG,51,4,973,122,302,0.404,35,108,0.324,87,194,0.448,0.462,32,40,0.8,14,85,99,33,26,10,26,56,311
557,Wayne Ellington,4,SG,78,21,1661,226,529,0.427,94,240,0.392,132,289,0.457,0.516,68,75,0.907,25,141,166,104,45,3,57,81,614
558,Toney Douglas,1,PG,56,12,1087,179,391,0.458,68,175,0.389,111,216,0.514,0.545,55,68,0.809,40,68,108,112,42,3,55,116,481
558,Toney Douglas,2,SG,81,9,1971,314,755,0.416,143,383,0.373,171,372,0.46,0.511,85,107,0.794,65,179,244,244,89,4,89,177,856
558,Toney Douglas,3,PG,38,9,656,94,290,0.324,27,117,0.231,67,173,0.387,0.371,22,26,0.846,16,56,72,77,29,1,56,55,237
558,Toney Douglas,4,PG,71,0,1289,188,466,0.403,82,216,0.38,106,250,0.424,0.491,76,84,0.905,34,104,138,151,71,3,81,145,534
559,Christian Eyenga,1,SF,44,18,947,130,306,0.425,25,91,0.275,105,215,0.488,0.466,18,28,0.643,27,96,123,35,34,28,47,78,303
559,Christian Eyenga,2,SF,7,0,102,6,25,0.24,1,3,0.333,5,22,0.227,0.26,4,8,0.5,4,10,14,5,3,5,3,7,17
559,Christian Eyenga,3,SF,6,0,83,3,19,0.158,1,2,0.5,2,17,0.118,0.184,2,6,0.333,3,9,12,4,3,4,2,7,9
559,Christian Eyenga,4,SF,1,0,19,3,6,0.5,0,1,0,3,5,0.6,0.5,2,2,1,1,1,2,1,0,1,1,0,8
560,Jeff Pendergraph,1,C,39,4,405,43,65,0.662,0,0,,43,65,0.662,0.662,18,20,0.9,25,73,98,1,7,16,12,76,104
560,Jeff Pendergraph,2,C,20,1,106,15,36,0.417,0,0,,15,36,0.417,0.417,4,7,0.571,12,21,33,4,3,2,2,16,34
560,Jeff Pendergraph,3,PF,37,0,369,61,126,0.484,2,4,0.5,59,122,0.484,0.492,21,23,0.913,29,75,104,15,6,12,23,44,145
560,Jeff Pendergraph,4,PF,73,10,952,101,174,0.58,0,0,,101,174,0.58,0.58,38,55,0.691,89,169,258,60,13,25,63,146,240
561,Jermaine Taylor,1,SG,31,4,303,45,119,0.378,5,22,0.227,40,97,0.412,0.399,33,46,0.717,21,25,46,16,10,3,19,15,128
561,Jermaine Taylor,2,SG,34,8,483,94,196,0.48,14,45,0.311,80,151,0.53,0.515,21,28,0.75,26,36,62,32,14,5,46,39,223
561,Jermaine Taylor,3,SG,8,0,77,16,32,0.5,2,5,0.4,14,27,0.519,0.531,5,6,0.833,1,8,9,2,2,2,6,4,39
561,Jermaine Taylor,4,SG,26,8,406,78,164,0.476,12,40,0.3,66,124,0.532,0.512,16,22,0.727,25,28,53,30,12,3,40,35,184
562,Dante Cunningham,1,PF,63,2,707,106,214,0.495,0,2,0,106,212,0.5,0.495,31,48,0.646,54,106,160,14,24,22,15,97,243
562,Dante Cunningham,2,PF,78,18,1637,218,472,0.462,1,13,0.077,217,459,0.473,0.463,45,62,0.726,96,181,277,43,54,43,51,177,482
562,Dante Cunningham,3,PF,56,9,1108,126,291,0.433,0,4,0,126,287,0.439,0.433,32,45,0.711,73,116,189,30,39,32,33,139,284
562,Dante Cunningham,4,PF,22,9,529,92,181,0.508,1,9,0.111,91,172,0.529,0.511,13,17,0.765,23,65,88,13,15,11,18,38,198
563,Sergio Llull,No NBA Data,,,,,,,,,,,,,,,,,,,,,,,,,,
564,DaJuan Summers,1,SF,44,0,405,46,130,0.354,15,42,0.357,31,88,0.352,0.412,27,38,0.711,14,31,45,16,8,7,16,52,134
564,DaJuan Summers,2,SF,22,1,199,28,69,0.406,9,21,0.429,19,48,0.396,0.471,9,20,0.45,2,10,12,2,3,1,13,21,74
564,DaJuan Summers,3,SF,15,6,209,28,65,0.431,5,16,0.313,23,49,0.469,0.469,7,9,0.778,8,15,23,10,7,0,8,31,68
564,DaJuan Summers,4,PF,2,0,7,1,4,0.25,0,0,,1,4,0.25,0.25,0,0,,0,2,2,1,0,0,0,0,2
565,Sam Young,1,SF,80,1,1321,224,497,0.451,11,56,0.196,213,441,0.483,0.462,136,175,0.777,77,124,201,52,34,20,94,106,595
565,Sam Young,2,SF,78,46,1577,233,494,0.472,17,50,0.34,216,444,0.486,0.489,89,116,0.767,40,147,187,71,68,23,61,120,572
565,Sam Young,3,SF,35,2,375,45,127,0.354,5,17,0.294,40,110,0.364,0.374,19,26,0.731,20,42,62,15,17,6,16,23,114
565,Sam Young,4,SF,21,2,240,32,83,0.386,0,9,0,32,74,0.432,0.386,10,12,0.833,14,27,41,9,11,2,9,12,74
566,DeJuan Blair,1,PF,82,23,1494,275,495,0.556,0,2,0,275,493,0.558,0.556,88,161,0.547,200,326,526,65,50,39,112,224,638
566,DeJuan Blair,2,PF,81,65,1734,292,583,0.501,0,2,0,292,581,0.503,0.501,90,137,0.657,215,350,565,77,95,42,113,213,674
566,DeJuan Blair,3,PF,64,62,1363,269,504,0.534,0,1,0,269,503,0.535,0.534,73,119,0.613,154,197,351,78,59,12,92,168,611
566,DeJuan Blair,4,PF,61,16,851,142,271,0.524,0,1,0,142,270,0.526,0.524,44,70,0.629,66,164,230,45,37,10,49,112,328
567,Jon Brockman,1,PF,52,4,654,55,103,0.534,0,0,,55,103,0.534,0.534,37,62,0.597,105,108,213,22,15,5,23,115,147
567,Jon Brockman,2,C,63,6,677,48,94,0.511,0,0,,48,94,0.511,0.511,40,59,0.678,74,110,184,18,14,3,24,119,136
567,Jon Brockman,3,PF,35,0,239,15,45,0.333,0,1,0,15,44,0.341,0.333,7,15,0.467,33,42,75,9,4,1,10,33,37
568,Jonas Jerebko,1,PF,80,73,2232,290,603,0.481,36,115,0.313,254,488,0.52,0.511,125,176,0.71,194,284,478,58,79,29,82,230,741
568,Jonas Jerebko,2,PF,64,13,1468,212,453,0.468,32,106,0.302,180,347,0.519,0.503,100,124,0.806,96,212,308,43,41,21,66,162,556
568,Jonas Jerebko,3,PF,49,2,892,142,316,0.449,25,83,0.301,117,233,0.502,0.489,68,88,0.773,68,117,185,43,38,8,42,90,377
568,Jonas Jerebko,4,PF,64,0,741,98,208,0.471,31,74,0.419,67,134,0.5,0.546,43,59,0.729,51,124,175,39,21,6,43,85,270
569,Derrick Brown,1,SF,57,0,535,68,147,0.463,2,7,0.286,66,140,0.471,0.469,48,72,0.667,31,47,78,19,21,10,19,53,186
569,Derrick Brown,2,SF,49,1,576,74,131,0.565,5,10,0.5,69,121,0.57,0.584,32,60,0.533,41,58,99,33,20,10,35,59,185
569,Derrick Brown,3,SF,41,1,488,62,113,0.549,2,6,0.333,60,107,0.561,0.558,25,47,0.532,32,52,84,29,16,8,28,48,151
569,Derrick Brown,4,SF,8,0,88,12,18,0.667,3,4,0.75,9,14,0.643,0.75,7,13,0.538,9,6,15,4,4,2,7,11,34
570,Jodie Meeks,1,SG,60,0,719,104,268,0.388,42,132,0.318,62,136,0.456,0.466,31,39,0.795,9,90,99,39,18,5,25,52,281
570,Jodie Meeks,2,SG,41,0,486,64,177,0.362,23,82,0.28,41,95,0.432,0.427,18,21,0.857,5,67,72,22,13,4,20,33,169
570,Jodie Meeks,3,SG,19,0,233,40,91,0.44,19,50,0.38,21,41,0.512,0.544,13,18,0.722,4,23,27,17,5,1,5,19,112
570,Jodie Meeks,4,SG,74,64,2062,242,570,0.425,138,348,0.397,104,222,0.468,0.546,152,170,0.894,21,150,171,78,63,4,60,97,774
571,Patrick Beverley,1,PG,41,0,713,79,189,0.418,36,96,0.375,43,93,0.462,0.513,34,41,0.829,45,64,109,117,37,21,44,83,228
571,Patrick Beverley,2,PG,56,55,1751,199,481,0.414,92,255,0.361,107,226,0.473,0.509,83,102,0.814,72,124,196,151,77,23,66,174,573
571,Patrick Beverley,3,PG,56,55,1727,204,532,0.383,115,323,0.356,89,209,0.426,0.492,45,60,0.75,67,170,237,192,59,23,83,182,568
571,Patrick Beverley,4,PG,71,63,2041,258,594,0.434,124,310,0.4,134,284,0.472,0.539,60,88,0.682,73,177,250,239,94,26,91,234,700
572,Marcus Thornton,1,SG,73,17,1872,398,883,0.451,117,313,0.374,281,570,0.493,0.517,144,177,0.814,72,139,211,114,58,11,76,127,1057
572,Marcus Thornton,2,SG,73,23,1775,350,807,0.434,88,240,0.367,262,567,0.462,0.488,145,184,0.788,61,197,258,135,64,9,93,110,933
572,Marcus Thornton,3,SG,46,0,745,137,334,0.41,35,93,0.376,102,241,0.423,0.463,50,66,0.758,25,106,131,43,19,4,37,50,359
572,Marcus Thornton,4,SG,27,23,1030,213,473,0.45,53,147,0.361,160,326,0.491,0.506,95,118,0.805,36,91,127,92,45,5,56,60,574
573,Chase Budinger,1,SF,74,4,1488,249,565,0.441,92,249,0.369,157,316,0.497,0.522,67,87,0.77,38,182,220,88,34,11,48,85,657
573,Chase Budinger,2,SF,78,22,1738,279,656,0.425,89,274,0.325,190,382,0.497,0.493,118,138,0.855,52,229,281,127,41,18,67,114,765
573,Chase Budinger,3,SF,58,9,1298,208,471,0.442,88,219,0.402,120,252,0.476,0.535,54,70,0.771,38,179,217,74,29,7,55,65,558
573,Chase Budinger,4,SF,23,1,508,79,191,0.414,26,81,0.321,53,110,0.482,0.482,32,42,0.762,15,56,71,25,14,7,23,29,216
574,Nick Calathes,1,SG,71,7,1173,142,311,0.457,19,61,0.311,123,250,0.492,0.487,44,72,0.611,23,114,137,207,66,8,101,117,347
574,Nick Calathes,2,SG,58,0,838,104,247,0.421,11,43,0.256,93,204,0.456,0.443,24,45,0.533,19,87,106,146,63,5,61,100,243
575,Danny Green,1,SG,20,0,115,15,39,0.385,6,22,0.273,9,17,0.529,0.462,4,6,0.667,8,9,17,5,6,3,5,9,40
575,Danny Green,2,SG,8,0,92,17,35,0.486,7,19,0.368,10,16,0.625,0.586,0,0,,3,12,15,2,2,1,5,7,41
575,Danny Green,3,SG,66,38,1522,211,477,0.442,102,234,0.436,109,243,0.449,0.549,79,100,0.79,54,174,228,86,58,46,67,107,603
575,Danny Green,4,SG,80,80,2201,297,663,0.448,177,413,0.429,120,250,0.48,0.581,67,79,0.848,36,208,244,141,92,54,94,124,838
576,Henk Norel,No NBA Data,,,,,,,,,,,,,,,,,,,,,,,,,,
577,Taylor Griffin,1,SF,8,0,32,4,10,0.4,0,2,0,4,8,0.5,0.4,2,4,0.5,0,2,2,1,0,2,1,4,10
578,Sergiy Gladyr,No NBA Data,,,,,,,,,,,,,,,,,,,,,,,,,,
579,Goran Suton,No NBA Data,,,,,,,,,,,,,,,,,,,,,,,,,,
580,Jack McClinton,No NBA Data,,,,,,,,,,,,,,,,,,,,,,,,,,
581,A.J. Price,1,PG,56,2,865,145,354,0.41,60,174,0.345,85,180,0.472,0.494,60,75,0.8,12,76,88,106,35,3,59,53,410
581,A.J. Price,2,PG,50,0,795,114,320,0.356,41,149,0.275,73,171,0.427,0.42,54,81,0.667,16,56,72,111,29,1,53,61,323
581,A.J. Price,3,PG,44,1,568,59,174,0.339,26,88,0.295,33,86,0.384,0.414,28,35,0.8,13,48,61,86,20,2,32,30,172
581,A.J. Price,4,PG,57,22,1278,161,413,0.39,70,200,0.35,91,213,0.427,0.475,49,62,0.79,20,94,114,205,33,3,64,73,441
582,Nando De Colo,1,SG,72,6,920,105,241,0.436,31,82,0.378,74,159,0.465,0.5,35,44,0.795,23,115,138,138,41,6,81,87,276
582,Nando De Colo,2,SF,47,3,494,64,153,0.418,18,53,0.34,46,100,0.46,0.477,31,35,0.886,14,59,73,65,22,6,35,48,177
582,Nando De Colo,3,SF,26,3,301,42,93,0.452,10,31,0.323,32,62,0.516,0.505,18,22,0.818,6,39,45,32,15,3,21,25,112
582,Nando De Colo,4,SF,21,0,193,22,60,0.367,8,22,0.364,14,38,0.368,0.433,13,13,1,8,20,28,33,7,3,14,23,65
583,Robert Vaden,No NBA Data,,,,,,,,,,,,,,,,,,,,,,,,,,
584,Patrick Mills,1,PG,10,0,38,10,24,0.417,2,4,0.5,8,20,0.4,0.458,4,7,0.571,1,1,2,5,0,0,4,6,26
584,Patrick Mills,2,PG,64,0,783,135,328,0.412,47,133,0.353,88,195,0.451,0.483,36,47,0.766,19,32,51,109,27,1,62,63,353
584,Patrick Mills,3,PG,16,3,261,63,130,0.485,24,56,0.429,39,74,0.527,0.577,15,15,1,4,24,28,39,10,1,26,14,165
584,Patrick Mills,4,PG,58,2,656,113,241,0.469,52,130,0.4,61,111,0.55,0.577,16,19,0.842,9,41,50,62,26,4,39,55,294
585,Ahmad Nivins,No NBA Data,,,,,,,,,,,,,,,,,,,,,,,,,,
586,Emir Preldzic,No NBA Data,,,,,,,,,,,,,,,,,,,,,,,,,,
587,Lester Hudson,1,PG,25,0,131,21,53,0.396,5,16,0.313,16,37,0.432,0.443,11,13,0.846,7,11,18,13,8,3,14,12,58
587,Lester Hudson,2,PG,16,0,70,7,18,0.389,3,5,0.6,4,13,0.308,0.472,5,6,0.833,3,5,8,8,3,2,9,7,22
587,Lester Hudson,3,PG,9,0,61,14,35,0.4,2,11,0.182,12,24,0.5,0.429,6,7,0.857,4,6,10,5,5,1,5,5,36
587,Lester Hudson,4,PG,11,0,73,6,24,0.25,4,15,0.267,2,9,0.222,0.333,2,4,0.5,1,4,5,17,4,1,7,10,18
588,Chinemelu Elonu,No NBA Data,,,,,,,,,,,,,,,,,,,,,,,,,,
589,Robert Dozier,No NBA Data,,,,,,,,,,,,,,,,,,,,,,,,,,
590,John Wall,1,PG,69,64,2606,398,972,0.409,34,115,0.296,364,857,0.425,0.427,301,393,0.766,35,282,317,574,121,35,261,175,1131
590,John Wall,2,PG,66,66,2386,378,894,0.423,3,42,0.071,375,852,0.44,0.424,317,402,0.789,48,252,300,530,95,57,255,137,1076
590,John Wall,3,PG,49,42,1602,324,735,0.441,12,45,0.267,312,690,0.452,0.449,246,306,0.804,35,161,196,373,65,37,157,117,906
590,John Wall,4,PG,82,82,2980,579,1337,0.433,108,308,0.351,471,1029,0.458,0.473,317,394,0.805,38,295,333,721,149,40,295,219,1583
591,Evan Turner,1,SG,78,14,1797,225,529,0.425,14,44,0.318,211,485,0.435,0.439,101,125,0.808,42,264,306,159,49,14,80,138,565
591,Evan Turner,2,SF,65,20,1713,263,590,0.446,11,49,0.224,252,541,0.466,0.455,73,108,0.676,27,349,376,180,40,20,105,117,610
591,Evan Turner,3,SF,82,82,2892,441,1053,0.419,58,159,0.365,383,894,0.428,0.446,154,208,0.74,56,461,517,354,71,17,187,197,1094
591,Evan Turner,4,SF,81,56,2457,434,1021,0.425,50,156,0.321,384,865,0.444,0.45,213,262,0.813,62,346,408,262,67,7,189,195,1131
592,Derrick Favors,1,PF,78,27,1535,215,416,0.517,0,0,,215,416,0.517,0.517,103,173,0.595,171,241,412,39,29,68,77,246,533
592,Derrick Favors,2,PF,56,23,1091,141,276,0.511,0,0,,141,276,0.511,0.511,71,116,0.612,126,171,297,21,18,41,56,183,353
592,Derrick Favors,3,PF,22,4,444,74,140,0.529,0,0,,74,140,0.529,0.529,32,57,0.561,45,70,115,18,11,27,21,63,180
592,Derrick Favors,4,PF,65,9,1376,222,445,0.499,0,0,,222,445,0.499,0.499,126,194,0.649,158,267,425,43,38,65,103,145,570
593,Wesley Johnson,1,SG,79,63,2069,271,682,0.397,103,289,0.356,168,393,0.427,0.473,64,92,0.696,51,189,240,148,58,54,95,163,709
593,Wesley Johnson,2,SF,65,64,1469,158,397,0.398,53,169,0.314,105,228,0.461,0.465,24,34,0.706,24,153,177,59,35,48,60,115,393
593,Wesley Johnson,3,SF,50,21,953,161,396,0.407,50,155,0.323,111,241,0.461,0.47,27,35,0.771,21,102,123,34,22,18,48,56,399
593,Wesley Johnson,4,SF,79,62,2240,277,651,0.425,100,271,0.369,177,380,0.466,0.502,61,77,0.792,70,278,348,124,86,77,90,207,715
594,DeMarcus Cousins,1,C,81,62,2309,432,1004,0.43,3,18,0.167,429,986,0.435,0.432,276,402,0.687,217,482,699,204,85,68,268,332,1143
594,DeMarcus Cousins,2,C,64,62,1950,448,999,0.448,2,14,0.143,446,985,0.453,0.449,262,373,0.702,265,438,703,102,93,75,170,257,1160
594,DeMarcus Cousins,3,C,75,74,2289,482,1036,0.465,4,22,0.182,478,1014,0.471,0.467,312,423,0.738,222,524,746,199,108,55,225,269,1280
594,DeMarcus Cousins,4,C,71,71,2298,591,1191,0.496,0,7,0,591,1184,0.499,0.496,432,595,0.726,218,613,831,207,109,91,251,270,1614
595,Ekpe Udoh,1,C,58,18,1030,97,222,0.437,0,0,,97,222,0.437,0.437,42,64,0.656,80,101,181,40,22,86,48,144,236
595,Ekpe Udoh,2,C,61,11,1290,127,295,0.431,0,2,0,127,293,0.433,0.431,86,114,0.754,100,154,254,57,40,102,53,174,340
595,Ekpe Udoh,3,C,38,6,827,82,185,0.443,0,0,,82,185,0.443,0.443,46,64,0.719,58,89,147,31,25,65,35,115,210
595,Ekpe Udoh,4,C,23,5,463,45,110,0.409,0,2,0,45,108,0.417,0.409,40,50,0.8,42,65,107,26,15,37,18,59,130
596,Greg Monroe,1,C,80,48,2222,303,550,0.551,0,1,0,303,549,0.552,0.551,145,233,0.622,248,353,601,105,93,45,81,196,751
596,Greg Monroe,2,C,66,66,2082,407,781,0.521,0,1,0,407,780,0.522,0.521,201,272,0.739,239,398,637,152,83,46,161,180,1015
596,Greg Monroe,3,C,81,81,2687,514,1058,0.486,0,4,0,514,1054,0.488,0.486,270,392,0.689,236,541,777,281,105,55,234,190,1298
596,Greg Monroe,4,PF,82,82,2690,504,1015,0.497,0,1,0,504,1014,0.497,0.497,241,367,0.657,256,504,760,171,91,47,166,205,1249
597,Al-Farouq Aminu,1,SF,81,14,1452,160,406,0.394,45,143,0.315,115,263,0.437,0.45,92,119,0.773,75,192,267,60,59,25,103,121,457
597,Al-Farouq Aminu,2,SF,66,21,1477,150,365,0.411,13,47,0.277,137,318,0.431,0.429,86,114,0.754,95,213,308,66,59,34,91,136,399
597,Al-Farouq Aminu,3,SF,76,71,2066,225,474,0.475,4,19,0.211,221,455,0.486,0.479,101,137,0.737,139,446,585,103,92,51,116,153,555
597,Al-Farouq Aminu,4,SF,80,65,2045,234,494,0.474,13,48,0.271,221,446,0.496,0.487,91,137,0.664,129,367,496,114,82,38,88,147,572
598,Gordon Hayward,1,SF,72,17,1218,142,293,0.485,35,74,0.473,107,219,0.489,0.544,69,97,0.711,41,98,139,81,30,19,70,106,388
598,Gordon Hayward,2,SF,66,58,2015,267,586,0.456,55,159,0.346,212,427,0.496,0.503,193,232,0.832,59,171,230,207,53,41,109,106,782
598,Gordon Hayward,3,SF,72,27,2104,336,773,0.435,102,246,0.415,234,527,0.444,0.501,243,294,0.827,51,174,225,213,58,38,120,125,1017
598,Gordon Hayward,4,SF,77,77,2800,426,1032,0.413,85,280,0.304,341,752,0.453,0.454,311,381,0.816,62,329,391,400,110,40,212,155,1248
599,Paul George,1,SG,61,19,1265,179,395,0.453,41,138,0.297,138,257,0.537,0.505,77,101,0.762,37,187,224,65,62,26,70,127,476
599,Paul George,2,SG,66,66,1958,281,639,0.44,90,234,0.385,191,405,0.472,0.51,146,182,0.802,56,314,370,158,108,38,117,191,798
599,Paul George,3,SF,79,79,2972,493,1176,0.419,170,469,0.362,323,707,0.457,0.491,221,274,0.807,88,515,603,327,143,51,233,227,1377
599,Paul George,4,SF,80,80,2898,577,1362,0.424,182,500,0.364,395,862,0.458,0.49,401,464,0.864,64,478,542,283,151,22,224,198,1737
600,Cole Aldrich,1,C,18,0,142,8,15,0.533,0,0,,8,15,0.533,0.533,2,4,0.5,13,22,35,4,5,7,8,30,18
600,Cole Aldrich,2,C,26,0,173,22,42,0.524,0,0,,22,42,0.524,0.524,13,14,0.929,13,35,48,3,8,16,9,22,57
600,Cole Aldrich,3,C,45,0,388,44,80,0.55,0,0,,44,80,0.55,0.55,12,20,0.6,30,90,120,9,5,23,23,60,100
600,Cole Aldrich,4,C,30,0,213,23,43,0.535,0,0,,23,43,0.535,0.535,4,9,0.444,12,45,57,6,3,9,14,41,50
601,Xavier Henry,1,SG,38,16,527,65,160,0.406,2,17,0.118,63,143,0.441,0.413,33,52,0.635,9,28,37,18,11,3,13,48,165
601,Xavier Henry,2,SG,45,0,759,90,228,0.395,7,17,0.412,83,211,0.393,0.41,52,85,0.612,24,82,106,35,26,8,35,59,239
601,Xavier Henry,3,SF,50,2,625,66,161,0.41,4,11,0.364,62,150,0.413,0.422,58,92,0.63,21,69,90,13,16,5,31,72,194
601,Xavier Henry,4,SF,43,5,908,144,345,0.417,28,81,0.346,116,264,0.439,0.458,116,177,0.655,25,89,114,51,44,7,57,79,432
602,Ed Davis,1,PF,65,17,1602,215,373,0.576,0,0,,215,373,0.576,0.576,71,128,0.555,168,294,462,40,39,67,48,183,501
602,Ed Davis,2,PF,66,9,1534,172,335,0.513,0,1,0,172,334,0.515,0.513,71,106,0.67,134,304,438,60,40,63,67,156,415
602,Ed Davis,3,C-PF,81,28,1631,260,482,0.539,0,0,,260,482,0.539,0.539,103,167,0.617,152,308,460,63,38,85,63,191,623
602,Ed Davis,4,C,45,24,1087,186,339,0.549,0,0,,186,339,0.549,0.549,66,102,0.647,95,205,300,55,25,38,45,111,438
603,Patrick Patterson,1,PF,52,6,868,149,267,0.558,0,2,0,149,265,0.562,0.558,30,42,0.714,86,114,200,41,17,37,31,77,328
603,Patrick Patterson,2,PF,64,1,1483,225,511,0.44,0,3,0,225,508,0.443,0.44,40,57,0.702,112,174,286,53,27,36,49,113,490
603,Patrick Patterson,3,PF,71,41,1775,319,623,0.512,51,132,0.386,268,491,0.546,0.553,48,63,0.762,113,224,337,81,31,40,61,138,737
603,Patrick Patterson,4,PF,47,38,1219,236,455,0.519,35,96,0.365,201,359,0.56,0.557,37,49,0.755,73,148,221,51,18,27,42,90,544
604,Larry Sanders,1,C,60,12,872,116,268,0.433,0,0,,116,268,0.433,0.433,28,50,0.56,59,119,178,16,22,72,38,117,260
604,Larry Sanders,2,PF,52,0,643,84,184,0.457,0,2,0,84,182,0.462,0.457,18,38,0.474,62,98,160,33,32,76,43,133,186
604,Larry Sanders,3,C,71,55,1937,306,605,0.506,0,2,0,306,603,0.507,0.506,84,136,0.618,224,448,672,83,53,201,87,233,696
604,Larry Sanders,4,C,23,20,584,76,162,0.469,0,1,0,76,161,0.472,0.469,26,55,0.473,60,105,165,19,18,40,26,74,178
605,Luke Babbitt,1,SF,24,0,137,15,55,0.273,3,16,0.188,12,39,0.308,0.3,3,9,0.333,6,24,30,6,2,2,8,15,36
605,Luke Babbitt,2,SF,40,4,537,71,173,0.41,43,100,0.43,28,73,0.384,0.535,17,20,0.85,16,79,95,16,10,4,27,46,202
605,Luke Babbitt,3,PF,62,0,730,86,234,0.368,62,178,0.348,24,56,0.429,0.5,10,13,0.769,15,122,137,29,14,5,22,82,244
605,Luke Babbitt,4,PF,27,2,473,60,154,0.39,36,95,0.379,24,59,0.407,0.506,14,18,0.778,18,70,88,29,7,11,15,52,170
606,Kevin Seraphin,1,PF,58,1,635,66,147,0.449,0,0,,66,147,0.449,0.449,22,31,0.71,80,72,152,10,17,28,42,126,154
606,Kevin Seraphin,2,C,57,21,1176,203,382,0.531,0,1,0,203,381,0.533,0.531,47,70,0.671,103,177,280,33,19,76,66,133,453
606,Kevin Seraphin,3,C,79,8,1721,330,716,0.461,0,0,,330,716,0.461,0.461,61,88,0.693,107,239,346,57,24,59,130,211,721
606,Kevin Seraphin,4,C,53,1,578,111,220,0.505,0,0,,111,220,0.505,0.505,27,31,0.871,53,75,128,17,3,26,41,103,249
607,Eric Bledsoe,1,PG,81,25,1841,206,486,0.424,32,116,0.276,174,370,0.47,0.457,99,133,0.744,68,155,223,289,92,26,194,130,543
607,Eric Bledsoe,2,PG,40,1,464,49,126,0.389,6,30,0.2,43,96,0.448,0.413,28,44,0.636,22,43,65,66,31,14,47,58,132
607,Eric Bledsoe,3,PG,76,12,1553,253,568,0.445,31,78,0.397,222,490,0.453,0.473,106,134,0.791,78,147,225,233,109,55,137,112,643
607,Eric Bledsoe,4,PG,43,40,1416,265,556,0.477,50,140,0.357,215,416,0.517,0.522,183,237,0.772,27,175,202,235,69,14,143,99,763
608,Avery Bradley,1,PG,31,0,162,23,67,0.343,0,5,0,23,62,0.371,0.343,6,12,0.5,4,13,17,12,9,0,16,20,52
608,Avery Bradley,2,PG,64,28,1368,200,402,0.498,22,54,0.407,178,348,0.511,0.525,62,78,0.795,34,81,115,87,43,12,75,109,484
608,Avery Bradley,3,PG,50,50,1435,192,478,0.402,40,126,0.317,152,352,0.432,0.444,37,49,0.755,30,81,111,104,64,19,72,129,461
608,Avery Bradley,4,SG,60,58,1855,361,825,0.438,79,200,0.395,282,625,0.451,0.485,90,112,0.804,48,178,226,85,63,11,96,145,891
609,James Anderson,1,SF,26,2,286,31,81,0.383,18,46,0.391,13,35,0.371,0.494,14,18,0.778,2,21,23,18,3,6,13,24,94
609,James Anderson,2,SG,51,2,603,66,174,0.379,19,68,0.279,47,106,0.443,0.434,39,52,0.75,16,63,79,41,8,2,30,35,190
609,James Anderson,3,SG-SF,39,2,401,52,126,0.413,21,60,0.35,31,66,0.47,0.496,24,28,0.857,18,54,72,42,15,5,25,25,149
609,James Anderson,4,SF,10,0,94,11,25,0.44,5,11,0.455,6,14,0.429,0.54,7,9,0.778,3,11,14,9,3,2,7,7,34
610,Craig Brackins,1,PF,3,0,33,4,16,0.25,0,5,0,4,11,0.364,0.25,0,0,,2,2,4,1,1,0,0,3,8
610,Craig Brackins,2,PF,14,1,88,9,33,0.273,3,9,0.333,6,24,0.25,0.318,1,2,0.5,5,10,15,8,0,1,4,6,22
611,Elliot Williams,1,SG,24,0,149,37,74,0.5,8,27,0.296,29,47,0.617,0.554,6,18,0.333,7,12,19,6,6,3,5,18,88
611,Elliot Williams,2,SG,67,2,1157,140,337,0.415,37,125,0.296,103,212,0.486,0.47,87,119,0.731,30,100,130,72,35,3,68,126,404
611,Elliot Williams,3,SG,13,0,119,14,37,0.378,8,18,0.444,6,19,0.316,0.486,1,4,0.25,0,8,8,12,4,0,4,12,37
611,Elliot Williams,4,SG,5,0,42,6,13,0.462,5,7,0.714,1,6,0.167,0.654,1,2,0.5,0,3,3,4,2,0,4,1,18
612,Trevor Booker,1,PF,65,14,1063,139,253,0.549,0,1,0,139,252,0.552,0.549,68,101,0.673,98,153,251,35,29,42,38,115,346
612,Trevor Booker,2,PF,50,32,1261,181,341,0.531,1,2,0.5,180,339,0.531,0.532,56,93,0.602,119,206,325,40,48,43,58,138,419
612,Trevor Booker,3,PF,48,14,887,108,220,0.491,0,5,0,108,215,0.502,0.491,40,72,0.556,98,141,239,40,32,16,31,95,256
612,Trevor Booker,4,PF,72,45,1553,222,403,0.551,0,2,0,222,401,0.554,0.551,47,76,0.618,149,230,379,64,41,45,58,131,491
613,Damion James,1,SF,25,9,403,46,103,0.447,0,3,0,46,100,0.46,0.447,18,28,0.643,17,68,85,20,16,12,25,36,110
613,Damion James,2,SF,7,7,170,13,35,0.371,0,1,0,13,34,0.382,0.371,8,12,0.667,7,26,33,3,7,7,12,17,34
613,Damion James,3,SF,2,0,0,0,0,,0,0,,0,0,,,0,0,,0,1,1,0,0,0,0,0,0
613,Damion James,4,SF,5,1,50,2,9,0.222,0,2,0,2,7,0.286,0.222,2,2,1,1,11,12,3,0,1,1,3,6
614,Dominique Jones,1,SG,18,0,135,14,45,0.311,0,4,0,14,41,0.341,0.311,14,17,0.824,6,19,25,19,5,3,10,7,42
614,Dominique Jones,2,SG,33,1,268,29,73,0.397,1,8,0.125,28,65,0.431,0.404,29,37,0.784,9,35,44,42,10,5,28,28,88
614,Dominique Jones,3,PG,29,3,338,40,109,0.367,1,9,0.111,39,100,0.39,0.372,35,53,0.66,18,27,45,83,14,2,38,29,116
615,Quincy Pondexter,1,SF,66,6,734,73,180,0.406,18,50,0.36,55,130,0.423,0.456,24,34,0.706,23,65,88,28,17,10,16,63,188
615,Quincy Pondexter,2,SF,64,8,1002,108,239,0.452,22,73,0.301,86,166,0.518,0.498,33,53,0.623,55,71,126,27,27,5,30,90,271
615,Quincy Pondexter,3,SF,59,1,1243,128,299,0.428,60,152,0.395,68,147,0.463,0.528,59,75,0.787,43,89,132,61,35,6,42,95,375
615,Quincy Pondexter,4,SG,15,2,270,31,79,0.392,11,34,0.324,20,45,0.444,0.462,21,26,0.808,10,16,26,20,5,1,15,18,94
616,Jordan Crawford,1,SG,42,18,1027,192,500,0.384,33,128,0.258,159,372,0.427,0.417,73,84,0.869,31,74,105,117,39,3,83,63,490
616,Jordan Crawford,2,SG,16,0,160,27,77,0.351,9,27,0.333,18,50,0.36,0.409,4,6,0.667,9,19,28,15,3,0,15,13,67
616,Jordan Crawford,3,SG,26,18,867,165,423,0.39,24,101,0.238,141,322,0.438,0.418,69,78,0.885,22,55,77,102,36,3,68,50,423
616,Jordan Crawford,4,SG,64,32,1753,349,872,0.4,79,273,0.289,270,599,0.451,0.446,161,203,0.793,44,124,168,190,59,5,141,111,938
617,Greivis Vasquez,1,SG,70,1,860,95,233,0.408,25,86,0.291,70,147,0.476,0.461,34,44,0.773,12,61,73,151,22,4,70,83,249
617,Greivis Vasquez,2,SG,66,26,1706,225,523,0.43,43,135,0.319,182,388,0.469,0.471,96,117,0.821,23,150,173,359,60,8,148,126,589
617,Greivis Vasquez,3,PG,78,78,2685,438,1012,0.433,83,243,0.342,355,769,0.462,0.474,124,154,0.805,43,294,337,704,66,6,247,190,1083
617,Greivis Vasquez,4,SG-PG,79,23,1779,277,658,0.421,109,289,0.377,168,369,0.455,0.504,95,108,0.88,20,153,173,323,31,5,128,143,758
618,Daniel Orton,1,PF,16,2,187,17,30,0.567,0,1,0,17,29,0.586,0.567,11,25,0.44,19,20,39,5,8,9,7,30,45
618,Daniel Orton,2,C,13,0,104,12,26,0.462,0,0,,12,26,0.462,0.462,9,17,0.529,13,13,26,4,4,3,4,13,33
618,Daniel Orton,3,C,22,4,251,21,47,0.447,0,0,,21,47,0.447,0.447,23,30,0.767,16,45,61,15,6,16,18,38,65
619,Lazar Hayward,1,SF,42,0,419,55,154,0.357,17,60,0.283,38,94,0.404,0.412,33,42,0.786,23,47,70,28,12,7,19,44,160
619,Lazar Hayward,2,SF,26,0,141,13,38,0.342,4,14,0.286,9,24,0.375,0.395,7,12,0.583,2,14,16,4,3,1,9,18,37
619,Lazar Hayward,3,SF,4,0,31,2,10,0.2,0,4,0,2,6,0.333,0.2,6,6,1,0,4,4,3,2,0,0,3,10
620,Tibor Pleiss,1,C,12,0,82,11,25,0.44,0,2,0,11,23,0.478,0.44,2,2,1,6,9,15,2,1,2,8,19,24
621,Dexter Pittman,1,C,2,0,11,1,3,0.333,0,0,,1,3,0.333,0.333,0,0,,1,2,3,0,0,0,2,2,2
621,Dexter Pittman,2,C,35,6,301,44,94,0.468,0,0,,44,94,0.468,0.468,18,28,0.643,27,44,71,9,8,8,17,73,106
621,Dexter Pittman,3,C,11,0,32,4,11,0.364,0,0,,4,11,0.364,0.364,0,3,0,7,5,12,0,0,0,3,8,8
621,Dexter Pittman,4,C,4,0,12,3,5,0.6,0,0,,3,5,0.6,0.6,0,0,,4,3,7,0,0,0,2,4,6
622,Hassan Whiteside,1,C,1,0,2,0,0,,0,0,,0,0,,,0,0,,0,0,0,0,0,0,0,2,0
622,Hassan Whiteside,2,C,18,0,109,12,27,0.444,0,0,,12,27,0.444,0.444,5,12,0.417,16,23,39,0,3,15,5,12,29
622,Hassan Whiteside,3,C,48,32,1142,243,387,0.628,0,0,,243,387,0.628,0.628,78,156,0.5,145,337,482,6,27,123,58,129,564
622,Hassan Whiteside,4,C,73,43,2125,413,682,0.606,0,0,,413,682,0.606,0.606,214,329,0.65,238,627,865,30,44,269,137,201,1040
623,Armon Johnson,1,PG,38,0,277,46,101,0.455,5,12,0.417,41,89,0.461,0.48,13,22,0.591,11,25,36,45,5,1,38,31,110
623,Armon Johnson,2,PG,9,0,124,20,43,0.465,1,3,0.333,19,40,0.475,0.477,6,6,1,1,12,13,11,5,0,6,9,47
623,Armon Johnson,3,PG,1,0,5,1,1,1,0,0,,1,1,1,1,0,0,,0,1,1,0,1,0,1,0,2
623,Armon Johnson,4,PG,8,0,119,19,42,0.452,1,3,0.333,18,39,0.462,0.464,6,6,1,1,11,12,11,4,0,5,9,45
624,Nemanja Bjelica,1,PF,60,0,1075,110,235,0.468,48,125,0.384,62,110,0.564,0.57,40,55,0.727,49,161,210,83,26,21,47,154,308
624,Nemanja Bjelica,2,PF,65,1,1190,151,356,0.424,56,177,0.316,95,179,0.531,0.503,45,61,0.738,57,187,244,79,40,20,59,154,403
624,Nemanja Bjelica,3,PF,67,21,1371,171,371,0.461,76,183,0.415,95,188,0.505,0.563,36,45,0.8,53,221,274,86,50,16,52,141,454
624,Nemanja Bjelica,4,PF,70,63,1651,258,544,0.474,95,236,0.403,163,308,0.529,0.562,63,83,0.759,120,306,426,141,51,55,80,182,674
625,Terrico White,No NBA Data,,,,,,,,,,,,,,,,,,,,,,,,,,
626,Darington Hobson,1,SG,5,0,39,2,13,0.154,0,6,0,2,7,0.286,0.154,0,0,,0,3,3,6,0,0,2,1,4
627,Andy Rautins,1,SG,5,0,24,3,7,0.429,1,4,0.25,2,3,0.667,0.5,1,2,0.5,0,1,1,3,1,0,7,0,8
628,Landry Fields,1,SG,82,81,2541,299,602,0.497,86,219,0.393,213,383,0.556,0.568,113,147,0.769,105,416,521,155,80,17,107,114,797
628,Landry Fields,2,SG,66,62,1894,236,513,0.46,31,121,0.256,205,392,0.523,0.49,77,137,0.562,59,219,278,169,79,17,102,99,580
628,Landry Fields,3,SF,51,22,1037,102,223,0.457,2,14,0.143,100,209,0.478,0.462,34,53,0.642,59,149,208,60,32,8,42,63,240
628,Landry Fields,4,SF,30,2,322,27,67,0.403,0,5,0,27,62,0.435,0.403,14,22,0.636,15,44,59,20,10,3,11,25,68
629,Lance Stephenson,1,SG,12,0,115,13,39,0.333,0,5,0,13,34,0.382,0.333,11,14,0.786,1,17,18,21,4,0,16,14,37
629,Lance Stephenson,2,SG,42,1,442,47,125,0.376,4,30,0.133,43,95,0.453,0.392,8,17,0.471,12,41,53,46,21,5,36,30,106
629,Lance Stephenson,3,SG,78,72,2278,275,598,0.46,62,188,0.33,213,410,0.52,0.512,75,115,0.652,47,257,304,223,81,16,109,162,687
629,Lance Stephenson,4,SG,78,78,2752,427,870,0.491,86,244,0.352,341,626,0.545,0.54,140,197,0.711,95,463,558,359,54,7,210,195,1080
630,Jarvis Varnado,1,PF,13,0,58,3,7,0.429,0,0,,3,7,0.429,0.429,2,4,0.5,2,7,9,3,1,2,6,10,8
630,Jarvis Varnado,2,PF,5,0,18,2,4,0.5,0,0,,2,4,0.5,0.5,2,4,0.5,1,2,3,1,1,0,1,1,6
630,Jarvis Varnado,3,PF,8,0,40,1,3,0.333,0,0,,1,3,0.333,0.333,0,0,,1,5,6,2,0,2,5,9,2
630,Jarvis Varnado,4,PF,24,0,339,36,60,0.6,0,0,,36,60,0.6,0.6,27,52,0.519,19,44,63,13,10,29,10,62,99
631,Da'Sean Butler,No NBA Data,,,,,,,,,,,,,,,,,,,,,,,,,,
632,Devin Ebanks,1,SG,20,0,118,21,51,0.412,2,5,0.4,19,46,0.413,0.431,18,23,0.783,15,12,27,2,4,5,6,7,62
632,Devin Ebanks,2,SG,24,12,396,37,89,0.416,0,9,0,37,80,0.463,0.416,23,35,0.657,26,28,54,12,11,6,18,26,97
632,Devin Ebanks,3,SF,19,3,197,24,73,0.329,6,22,0.273,18,51,0.353,0.37,11,14,0.786,10,31,41,10,3,1,11,23,65
633,Jerome Jordan,1,C,21,0,108,17,33,0.515,0,0,,17,33,0.515,0.515,8,10,0.8,14,13,27,4,1,6,2,15,42
633,Jerome Jordan,2,C,44,0,383,50,94,0.532,0,0,,50,94,0.532,0.532,38,44,0.864,52,53,105,13,8,15,22,58,138
634,Paulao Prestes,No NBA Data,,,,,,,,,,,,,,,,,,,,,,,,,,
635,Gani Lawal,1,PF,1,0,2,0,0,,0,0,,0,0,,,0,0,,0,0,0,0,0,0,0,1,0
636,Tiny Gallon,No NBA Data,,,,,,,,,,,,,,,,,,,,,,,,,,
637,Latavious Williams,No NBA Data,,,,,,,,,,,,,,,,,,,,,,,,,,
638,Ryan Richards,No NBA Data,,,,,,,,,,,,,,,,,,,,,,,,,,
639,Solomon Alabi,1,C,12,0,59,3,15,0.2,0,0,,3,15,0.2,0.2,0,2,0,7,7,14,2,2,2,3,5,6
639,Solomon Alabi,2,C,14,0,122,13,36,0.361,0,0,,13,36,0.361,0.361,7,8,0.875,15,32,47,3,2,9,5,11,33
640,Magnum Rolle,No NBA Data,,,,,,,,,,,,,,,,,,,,,,,,,,
641,Luke Harangody,1,PF,49,0,640,79,206,0.383,16,66,0.242,63,140,0.45,0.422,19,26,0.731,40,103,143,30,15,17,16,80,193
641,Luke Harangody,2,PF,28,0,241,28,71,0.394,2,10,0.2,26,61,0.426,0.408,5,8,0.625,17,38,55,10,4,7,5,36,63
641,Luke Harangody,3,PF,21,0,399,51,135,0.378,14,56,0.25,37,79,0.468,0.43,14,18,0.778,23,65,88,20,11,10,11,44,130
641,Luke Harangody,4,PF,21,1,231,23,65,0.354,5,21,0.238,18,44,0.409,0.392,9,12,0.75,20,33,53,6,6,3,4,17,60
642,Pape Sy,1,SF,3,0,21,2,6,0.333,0,1,0,2,5,0.4,0.333,3,3,1,2,1,3,2,1,0,3,1,7
643,Willie Warren,1,PG,19,0,134,13,35,0.371,5,15,0.333,8,20,0.4,0.443,6,8,0.75,1,11,12,27,6,0,8,16,37
644,Jeremy Evans,1,SF,49,3,463,76,115,0.661,0,1,0,76,114,0.667,0.661,26,37,0.703,36,61,97,24,17,17,19,50,178
644,Jeremy Evans,2,SF,29,0,217,27,42,0.643,0,1,0,27,41,0.659,0.643,8,16,0.5,19,31,50,13,6,24,5,23,62
644,Jeremy Evans,3,PF,37,0,215,27,44,0.614,0,1,0,27,43,0.628,0.614,21,33,0.636,26,32,58,11,8,13,8,30,75
644,Jeremy Evans,4,SF,66,4,1209,175,332,0.527,0,2,0,175,330,0.53,0.527,51,75,0.68,120,190,310,44,42,46,40,139,401
645,Hamady N'Diaye,1,C,16,0,80,4,5,0.8,0,0,,4,5,0.8,0.8,6,12,0.5,2,5,7,0,2,5,3,18,14
645,Hamady N'Diaye,2,C,3,0,3,0,1,0,0,0,,0,1,0,0,0,0,,0,0,0,0,0,0,0,0,0
645,Hamady N'Diaye,3,C,14,0,74,3,9,0.333,0,0,,3,9,0.333,0.333,0,1,0,5,13,18,3,0,4,3,15,6
646,Ryan Reid,1,PF,5,0,17,4,5,0.8,0,0,,4,5,0.8,0.8,0,0,,1,1,2,0,0,0,1,1,8
647,Derrick Caracter,1,C,41,0,215,32,66,0.485,0,0,,32,66,0.485,0.485,17,23,0.739,19,24,43,7,4,10,19,47,81
648,Stanley Robinson,No NBA Data,,,,,,,,,,,,,,,,,,,,,,,,,,
649,Dwayne Collins,No NBA Data,,,,,,,,,,,,,,,,,,,,,,,,,,
650,Kyrie Irving,1,PG,51,51,1558,350,747,0.469,73,183,0.399,277,564,0.491,0.517,171,196,0.872,44,147,191,275,54,20,160,110,944
650,Kyrie Irving,2,PG,59,59,2048,484,1070,0.452,109,279,0.391,375,791,0.474,0.503,248,290,0.855,34,182,216,350,89,21,191,146,1325
650,Kyrie Irving,3,PG,71,71,2496,532,1237,0.43,123,344,0.358,409,893,0.458,0.48,291,338,0.861,52,207,259,433,108,23,190,163,1478
650,Kyrie Irving,4,PG,75,75,2730,578,1235,0.468,157,378,0.415,421,857,0.491,0.532,315,365,0.863,55,182,237,389,114,20,186,146,1628
651,Derrick Williams,1,PF,66,15,1418,205,498,0.412,37,138,0.268,168,360,0.467,0.449,136,195,0.697,77,234,311,38,30,31,77,95,583
651,Derrick Williams,2,PF,78,56,1916,338,786,0.43,65,196,0.332,273,590,0.463,0.471,192,272,0.706,96,334,430,46,44,37,101,127,933
651,Derrick Williams,3,SF-PF,78,15,1820,206,482,0.427,26,99,0.263,180,383,0.47,0.454,186,259,0.718,71,252,323,56,48,20,76,114,624
651,Derrick Williams,4,PF,11,0,162,19,54,0.352,2,15,0.133,17,39,0.436,0.37,14,16,0.875,3,23,26,1,4,4,6,9,54
652,Enes Kanter,1,C,66,0,874,117,236,0.496,0,1,0,117,235,0.498,0.496,70,105,0.667,107,171,278,8,18,23,54,87,304
652,Enes Kanter,2,C,70,2,1078,206,379,0.544,1,1,1,205,378,0.542,0.545,93,117,0.795,135,169,304,31,28,32,101,116,506
652,Enes Kanter,3,C,80,37,2138,419,853,0.491,0,1,0,419,852,0.492,0.491,149,204,0.73,222,376,598,75,28,42,144,230,987
652,Enes Kanter,4,C,75,74,2135,482,928,0.519,16,45,0.356,466,883,0.528,0.528,183,234,0.782,277,394,671,55,36,29,145,189,1163
653,Tristan Thompson,1,PF,60,25,1424,194,442,0.439,0,2,0,194,440,0.441,0.439,106,192,0.552,187,202,389,27,27,62,81,134,494
653,Tristan Thompson,2,PF,82,82,2564,390,799,0.488,0,3,0,390,796,0.49,0.488,177,291,0.608,306,467,773,108,60,71,123,234,957
653,Tristan Thompson,3,PF,82,82,2594,363,761,0.477,0,1,0,363,760,0.478,0.477,235,339,0.693,269,485,754,72,42,35,108,188,961
653,Tristan Thompson,4,PF,82,15,2194,267,488,0.547,0,0,,267,488,0.547,0.547,159,248,0.641,274,383,657,39,34,61,83,189,693
654,Jonas Valanciunas,1,C,62,57,1482,204,366,0.557,0,0,,204,366,0.557,0.557,146,185,0.789,121,251,372,45,17,78,94,188,554
654,Jonas Valanciunas,2,C,81,81,2282,359,676,0.531,0,1,0,359,675,0.532,0.531,198,260,0.762,226,488,714,57,24,71,136,249,916
654,Jonas Valanciunas,3,C,80,80,2096,373,652,0.572,0,1,0,373,651,0.573,0.572,217,276,0.786,215,478,693,39,33,95,109,222,963
654,Jonas Valanciunas,4,C,60,59,1557,303,536,0.565,0,0,,303,536,0.565,0.565,162,213,0.761,184,363,547,42,25,80,85,158,768
655,Jan Vesely,1,PF,57,20,1078,117,218,0.537,0,1,0,117,217,0.539,0.537,33,62,0.532,101,148,249,47,39,32,60,156,267
655,Jan Vesely,2,PF,51,4,601,57,114,0.5,0,1,0,57,113,0.504,0.5,12,39,0.308,43,79,122,28,15,17,27,107,126
655,Jan Vesely,3,PF,54,1,776,89,173,0.514,0,0,,89,173,0.514,0.514,19,56,0.339,81,110,191,21,53,35,36,121,197
655,Jan Vesely,4,PF,33,1,470,48,92,0.522,0,0,,48,92,0.522,0.522,8,30,0.267,53,60,113,10,26,19,22,64,104
656,Bismack Biyombo,1,C,63,41,1455,129,278,0.464,0,0,,129,278,0.464,0.464,69,143,0.483,113,255,368,27,20,115,71,145,327
656,Bismack Biyombo,2,C,80,65,2186,156,346,0.451,0,0,,156,346,0.451,0.451,74,142,0.521,194,388,582,35,28,143,82,195,386
656,Bismack Biyombo,3,C,77,9,1072,88,144,0.611,0,0,,88,144,0.611,0.611,46,89,0.517,105,261,366,8,7,86,40,124,222
656,Bismack Biyombo,4,C,64,21,1243,101,186,0.543,0,0,,101,186,0.543,0.543,102,175,0.583,159,248,407,16,18,99,52,140,304
657,Brandon Knight,1,PG,66,60,2129,319,769,0.415,105,276,0.38,214,493,0.434,0.483,104,137,0.759,33,178,211,251,49,10,171,154,847
657,Brandon Knight,2,PG,75,75,2365,357,878,0.407,120,327,0.367,237,551,0.43,0.475,165,225,0.733,54,193,247,303,58,8,205,157,999
657,Brandon Knight,3,PG,72,69,2400,461,1092,0.422,110,338,0.325,351,754,0.466,0.473,259,323,0.802,46,209,255,352,69,17,188,146,1291
657,Brandon Knight,4,PG-SG,63,61,2035,375,888,0.422,125,321,0.389,250,567,0.441,0.493,195,223,0.874,28,216,244,330,90,10,189,114,1070
658,Kemba Walker,1,PG,66,25,1792,281,767,0.366,69,226,0.305,212,541,0.392,0.411,168,213,0.789,30,204,234,289,60,20,119,79,799
658,Kemba Walker,2,PG,82,82,2859,526,1244,0.423,107,332,0.322,419,912,0.459,0.466,296,371,0.798,60,223,283,471,160,31,200,153,1455
658,Kemba Walker,3,PG,73,73,2614,449,1143,0.393,109,327,0.333,340,816,0.417,0.441,282,337,0.837,39,267,306,447,86,32,169,128,1289
658,Kemba Walker,4,PG,62,58,2119,378,981,0.385,85,280,0.304,293,701,0.418,0.429,234,283,0.827,35,185,220,318,89,31,100,92,1075
659,Jimmer Fredette,1,PG,61,7,1135,172,446,0.386,78,216,0.361,94,230,0.409,0.473,40,48,0.833,17,56,73,108,30,3,67,73,462
659,Jimmer Fredette,2,SG,69,0,967,172,409,0.421,65,156,0.417,107,253,0.423,0.5,85,99,0.859,19,52,71,92,31,3,68,64,494
659,Jimmer Fredette,3,SG,49,0,519,107,227,0.471,40,84,0.476,67,143,0.469,0.559,19,21,0.905,8,44,52,64,14,3,48,35,273
659,Jimmer Fredette,4,SG,41,0,463,94,198,0.475,36,73,0.493,58,125,0.464,0.566,17,19,0.895,7,38,45,61,14,3,44,28,241
660,Klay Thompson,1,SG,66,29,1608,318,718,0.443,111,268,0.414,207,450,0.46,0.52,79,91,0.868,24,137,161,133,49,20,103,155,826
660,Klay Thompson,2,SG,82,82,2936,508,1205,0.422,211,526,0.401,297,679,0.437,0.509,132,157,0.841,32,274,306,183,86,45,157,237,1359
660,Klay Thompson,3,SG,81,81,2868,559,1259,0.444,223,535,0.417,336,724,0.464,0.533,147,185,0.795,38,211,249,181,74,37,135,234,1488
660,Klay Thompson,4,SG,77,77,2455,602,1299,0.463,239,545,0.439,363,754,0.481,0.555,225,256,0.879,27,220,247,222,87,60,149,122,1668
661,Alec Burks,1,SG,59,0,939,153,357,0.429,15,45,0.333,138,312,0.442,0.45,104,143,0.727,57,75,132,55,27,5,51,84,425
661,Alec Burks,2,SG,64,0,1137,163,388,0.42,33,92,0.359,130,296,0.439,0.463,92,129,0.713,37,108,145,92,35,13,74,114,451
661,Alec Burks,3,SG,78,12,2193,380,831,0.457,50,143,0.35,330,688,0.48,0.487,279,373,0.748,59,198,257,212,69,14,149,190,1089
661,Alec Burks,4,SG,27,27,899,121,300,0.403,26,68,0.382,95,232,0.409,0.447,106,129,0.822,19,95,114,82,17,5,52,64,374
662,Markieff Morris,1,PF,63,7,1227,174,436,0.399,43,124,0.347,131,312,0.42,0.448,76,106,0.717,69,210,279,65,41,42,70,179,467
662,Markieff Morris,2,PF,82,32,1837,266,653,0.407,45,134,0.336,221,519,0.426,0.442,93,127,0.732,131,265,396,108,77,64,104,209,670
662,Markieff Morris,3,PF,81,0,2153,411,845,0.486,34,108,0.315,377,737,0.512,0.507,259,327,0.792,139,346,485,144,68,51,147,232,1115
662,Markieff Morris,4,PF,82,82,2581,512,1100,0.465,57,179,0.318,455,921,0.494,0.491,177,232,0.763,110,396,506,192,101,39,170,245,1258
663,Marcus Morris,1,PF,17,0,126,16,54,0.296,2,17,0.118,14,37,0.378,0.315,6,8,0.75,5,11,16,3,2,2,4,12,40
663,Marcus Morris,2,PF-SF,77,23,1524,222,526,0.422,86,233,0.369,136,293,0.464,0.504,66,117,0.564,80,197,277,62,45,20,77,160,596
663,Marcus Morris,3,PF,54,17,1154,171,400,0.428,74,194,0.381,97,206,0.471,0.52,49,75,0.653,63,156,219,47,27,16,53,120,465
663,Marcus Morris,4,SF,23,6,370,51,126,0.405,12,39,0.308,39,87,0.448,0.452,17,42,0.405,17,41,58,15,18,4,24,40,131
664,Kawhi Leonard,1,SF,64,39,1534,199,404,0.493,41,109,0.376,158,295,0.536,0.543,68,88,0.773,104,223,327,70,85,24,44,88,507
664,Kawhi Leonard,2,SF,58,57,1810,260,526,0.494,65,174,0.374,195,352,0.554,0.556,104,126,0.825,63,283,346,93,97,32,62,99,689
664,Kawhi Leonard,3,SF,66,65,1923,337,645,0.522,69,182,0.379,268,463,0.579,0.576,101,126,0.802,76,336,412,133,114,50,80,127,844
664,Kawhi Leonard,4,SF,64,64,2033,394,822,0.479,67,192,0.349,327,630,0.519,0.52,202,252,0.802,85,376,461,161,148,48,97,128,1057
665,Nikola Vucevic,1,C,51,15,812,131,291,0.45,3,8,0.375,128,283,0.452,0.455,18,34,0.529,88,158,246,31,20,34,33,111,283
665,Nikola Vucevic,2,C,77,77,2559,461,889,0.519,0,3,0,461,886,0.52,0.519,86,126,0.683,273,644,917,143,61,79,141,218,1008
665,Nikola Vucevic,3,C,57,57,1812,353,696,0.507,0,0,,353,696,0.507,0.507,105,137,0.766,185,441,626,104,60,47,112,169,811
665,Nikola Vucevic,4,C,74,74,2529,631,1206,0.523,2,6,0.333,629,1200,0.524,0.524,164,218,0.752,238,572,810,147,54,54,148,220,1428
666,Iman Shumpert,1,PG,59,35,1705,214,534,0.401,48,157,0.306,166,377,0.44,0.446,87,109,0.798,42,144,186,164,101,8,111,173,563
666,Iman Shumpert,2,SG,45,45,996,109,275,0.396,51,127,0.402,58,148,0.392,0.489,36,47,0.766,31,105,136,75,43,7,37,99,305
666,Iman Shumpert,3,SG,74,58,1962,183,484,0.378,76,228,0.333,107,256,0.418,0.457,53,71,0.746,81,227,308,129,92,13,79,209,495
666,Iman Shumpert,4,SG,62,25,1545,193,471,0.41,67,196,0.342,126,275,0.458,0.481,43,64,0.672,55,169,224,135,81,16,91,138,496
667,Chris Singleton,1,SF,66,51,1431,116,312,0.372,44,127,0.346,72,185,0.389,0.442,30,44,0.682,43,190,233,49,70,30,38,176,306
667,Chris Singleton,2,PF,57,11,924,92,241,0.382,7,36,0.194,85,205,0.415,0.396,40,70,0.571,51,133,184,37,38,24,45,124,231
667,Chris Singleton,3,SF,25,0,250,25,67,0.373,7,19,0.368,18,48,0.375,0.425,18,25,0.72,18,37,55,6,9,3,17,25,75
668,Tobias Harris,1,SF,42,9,479,79,169,0.467,6,23,0.261,73,146,0.5,0.485,44,54,0.815,30,71,101,22,13,7,31,45,208
668,Tobias Harris,2,SF-PF,55,34,1299,233,512,0.455,34,108,0.315,199,404,0.493,0.488,103,137,0.752,73,214,287,69,32,44,66,120,603
668,Tobias Harris,3,SF,28,14,325,53,115,0.461,7,21,0.333,46,94,0.489,0.491,23,26,0.885,17,40,57,13,8,7,18,31,136
668,Tobias Harris,4,PF,27,20,974,180,397,0.453,27,87,0.31,153,310,0.494,0.487,80,111,0.721,56,174,230,56,24,37,48,89,467
669,Donatas Motiejunas,1,PF,44,14,538,97,213,0.455,24,83,0.289,73,130,0.562,0.512,32,51,0.627,36,57,93,31,7,10,37,73,250
669,Donatas Motiejunas,2,PF,62,3,952,131,296,0.443,21,84,0.25,110,212,0.519,0.478,58,96,0.604,60,165,225,34,20,21,49,132,341
669,Donatas Motiejunas,3,PF,71,62,2037,353,700,0.504,49,133,0.368,304,567,0.536,0.539,100,166,0.602,137,284,421,130,56,34,123,203,855
669,Donatas Motiejunas,4,PF,37,22,547,90,205,0.439,16,57,0.281,74,148,0.5,0.478,34,53,0.642,37,72,109,41,17,5,44,69,230
670,Nolan Smith,1,PG,44,4,541,67,180,0.372,13,45,0.289,54,135,0.4,0.408,20,28,0.714,17,39,56,62,18,3,42,55,167
670,Nolan Smith,2,PG,40,0,288,42,114,0.368,6,28,0.214,36,86,0.419,0.395,20,28,0.714,7,20,27,35,7,1,29,26,110
671,Kenneth Faried,1,PF,46,39,1037,181,309,0.586,0,0,,181,309,0.586,0.586,109,164,0.665,142,210,352,36,34,47,54,116,471
671,Kenneth Faried,2,PF,80,80,2248,380,689,0.552,0,0,,380,689,0.552,0.552,163,266,0.613,260,474,734,77,81,83,113,234,923
671,Kenneth Faried,3,PF,80,77,2178,447,820,0.545,0,3,0,447,817,0.547,0.545,202,311,0.65,238,446,684,96,70,69,135,193,1096
671,Kenneth Faried,4,PF,75,71,2086,373,736,0.507,1,8,0.125,372,728,0.511,0.507,199,288,0.691,242,426,668,89,62,57,118,211,946
672,Nikola Mirotic,1,PF,82,3,1654,253,624,0.405,99,313,0.316,154,311,0.495,0.485,228,284,0.803,63,341,404,97,54,54,89,172,833
672,Nikola Mirotic,2,PF,66,38,1646,248,609,0.407,135,346,0.39,113,263,0.43,0.518,146,181,0.807,58,304,362,100,58,46,102,151,777
672,Nikola Mirotic,3,PF,70,15,1679,258,625,0.413,129,377,0.342,129,248,0.52,0.516,99,128,0.773,61,323,384,75,53,55,80,128,744
672,Nikola Mirotic,4,PF,55,14,1494,306,684,0.447,135,358,0.377,171,326,0.525,0.546,112,137,0.818,59,346,405,80,44,39,62,108,859
673,Reggie Jackson,1,PG,45,0,501,51,159,0.321,13,62,0.21,38,97,0.392,0.362,25,29,0.862,14,39,53,71,25,1,36,31,140
673,Reggie Jackson,2,PG,70,0,993,149,325,0.458,24,104,0.231,125,221,0.566,0.495,52,62,0.839,21,145,166,122,29,13,53,84,374
673,Reggie Jackson,3,PG,80,36,2277,403,916,0.44,83,245,0.339,320,671,0.477,0.485,158,177,0.893,43,270,313,331,85,9,168,142,1047
673,Reggie Jackson,4,PG,77,40,2268,432,996,0.434,72,241,0.299,360,755,0.477,0.47,181,218,0.83,56,271,327,462,62,9,186,167,1117
674,MarShon Brooks,1,SG,56,47,1648,274,640,0.428,47,150,0.313,227,490,0.463,0.465,113,148,0.764,70,130,200,131,52,15,118,116,708
674,MarShon Brooks,2,SG,73,2,912,155,335,0.463,15,55,0.273,140,280,0.5,0.485,69,94,0.734,32,72,104,76,34,16,69,93,394
674,MarShon Brooks,3,SG,35,0,316,57,125,0.456,13,25,0.52,44,100,0.44,0.508,32,44,0.727,10,44,54,25,14,4,24,21,159
674,MarShon Brooks,4,SG,10,0,73,9,24,0.375,2,4,0.5,7,20,0.35,0.417,11,14,0.786,1,18,19,4,1,1,7,5,31
675,Jordan Hamilton,1,SF,26,2,258,48,111,0.432,17,47,0.362,31,64,0.484,0.509,2,5,0.4,11,51,62,20,4,3,16,15,115
675,Jordan Hamilton,2,SF,40,1,397,84,201,0.418,27,73,0.37,57,128,0.445,0.485,13,26,0.5,32,63,95,23,15,8,19,24,208
675,Jordan Hamilton,3,SF,60,12,1019,147,376,0.391,70,198,0.354,77,178,0.433,0.484,40,51,0.784,32,162,194,52,44,20,46,67,404
675,Jordan Hamilton,4,SF,39,11,670,99,254,0.39,45,129,0.349,54,125,0.432,0.478,23,31,0.742,23,110,133,34,31,13,27,31,266
676,JaJuan Johnson,1,PF,36,0,298,54,121,0.446,0,0,,54,121,0.446,0.446,6,9,0.667,20,38,58,6,5,14,14,25,114
677,Norris Cole,1,PG,65,2,1260,177,450,0.393,21,76,0.276,156,374,0.417,0.417,66,85,0.776,21,70,91,133,44,2,105,124,441
677,Norris Cole,2,PG,80,4,1590,179,425,0.421,35,98,0.357,144,327,0.44,0.462,52,80,0.65,18,112,130,164,57,7,104,155,445
677,Norris Cole,3,PG,82,6,2014,207,500,0.414,60,174,0.345,147,326,0.451,0.474,53,68,0.779,17,143,160,248,77,5,127,156,527
677,Norris Cole,4,PG,75,25,1831,230,558,0.412,55,176,0.313,175,382,0.458,0.461,58,81,0.716,13,146,159,255,57,15,99,124,573
678,Cory Joseph,1,PG,29,1,266,22,70,0.314,3,15,0.2,19,55,0.345,0.336,11,17,0.647,5,20,25,34,7,3,12,16,58
678,Cory Joseph,2,PG,28,9,388,51,110,0.464,6,21,0.286,45,89,0.506,0.491,18,21,0.857,12,40,52,53,15,4,21,25,126
678,Cory Joseph,3,SG,68,19,936,126,265,0.475,12,38,0.316,114,227,0.502,0.498,79,96,0.823,32,75,107,114,35,14,43,84,343
678,Cory Joseph,4,PG,79,14,1444,207,411,0.504,16,44,0.364,191,367,0.52,0.523,105,143,0.734,44,148,192,188,46,17,67,105,535
679,Jimmy Butler,1,SG,42,0,359,32,79,0.405,2,11,0.182,30,68,0.441,0.418,43,56,0.768,23,33,56,14,11,5,14,20,109
679,Jimmy Butler,2,SF,82,20,2134,239,512,0.467,40,105,0.381,199,407,0.489,0.506,187,233,0.803,136,192,328,115,78,31,62,97,705
679,Jimmy Butler,3,SG,67,67,2591,275,693,0.397,68,240,0.283,207,453,0.457,0.446,260,338,0.769,87,243,330,175,127,36,102,106,878
679,Jimmy Butler,4,SG,65,65,2513,421,912,0.462,73,193,0.378,348,719,0.484,0.502,386,463,0.834,114,265,379,212,114,36,93,108,1301
680,Bojan Bogdanovic,1,SF,78,28,1854,261,576,0.453,91,256,0.355,170,320,0.531,0.532,87,106,0.821,50,163,213,68,34,9,78,104,700
680,Bojan Bogdanovic,2,SF,79,39,2115,324,749,0.433,129,338,0.382,195,411,0.474,0.519,110,132,0.833,36,219,255,99,29,5,115,119,887
680,Bojan Bogdanovic,3,SF,81,54,2083,376,845,0.445,144,392,0.367,232,453,0.512,0.53,217,243,0.893,37,240,277,111,34,7,131,146,1113
680,Bojan Bogdanovic,4,SF,55,54,1482,269,611,0.44,99,277,0.357,170,334,0.509,0.521,146,167,0.874,23,174,197,90,24,3,93,99,783
681,Justin Harper,1,PF,14,0,84,9,31,0.29,2,13,0.154,7,18,0.389,0.323,0,1,0,3,9,12,2,2,3,6,5,20
681,Justin Harper,2,PF,5,0,35,4,10,0.4,4,9,0.444,0,1,0,0.6,1,2,0.5,0,1,1,0,1,0,2,3,13
681,Justin Harper,3,PF,3,0,31,5,12,0.417,2,7,0.286,3,5,0.6,0.5,0,0,,2,3,5,2,0,0,4,2,12
682,Kyle Singler,1,SF,82,74,2293,275,642,0.428,70,200,0.35,205,442,0.464,0.483,100,124,0.806,109,221,330,77,57,37,98,217,720
682,Kyle Singler,2,SF,82,36,2337,269,602,0.447,94,246,0.382,175,356,0.492,0.525,152,184,0.826,116,187,303,75,61,38,79,211,784
682,Kyle Singler,3,SF,80,58,1743,172,446,0.386,96,241,0.398,76,205,0.371,0.493,40,52,0.769,33,161,194,85,47,21,55,153,480
682,Kyle Singler,4,SF,54,40,1287,140,350,0.4,76,187,0.406,64,163,0.393,0.509,29,36,0.806,23,116,139,67,33,14,42,98,385
683,Shelvin Mack,1,PG,64,0,779,88,220,0.4,12,42,0.286,76,178,0.427,0.427,42,59,0.712,12,80,92,131,28,2,48,50,230
683,Shelvin Mack,2,PG-SG,31,3,416,58,126,0.46,18,49,0.367,40,77,0.519,0.532,9,16,0.563,3,37,40,68,15,0,34,39,143
683,Shelvin Mack,3,PG,7,2,141,16,40,0.4,4,13,0.308,12,27,0.444,0.45,1,2,0.5,3,13,16,23,6,0,8,10,37
683,Shelvin Mack,4,SG,4,0,7,1,2,0.5,0,1,0,1,1,1,0.5,0,0,,0,0,0,1,0,0,2,1,2
684,Tyler Honeycutt,1,SF,15,0,88,8,24,0.333,1,3,0.333,7,21,0.333,0.354,3,5,0.6,3,11,14,7,4,3,2,3,20
684,Tyler Honeycutt,2,SF,9,0,32,3,11,0.273,0,2,0,3,9,0.333,0.273,2,2,1,3,7,10,2,0,1,5,2,8
685,Jordan Williams,1,C,43,5,635,77,152,0.507,0,0,,77,152,0.507,0.507,43,66,0.652,66,90,156,11,21,15,23,61,197
686,Trey Thompkins,1,C,24,0,119,24,61,0.393,4,13,0.308,20,48,0.417,0.426,5,7,0.714,4,20,24,3,3,3,6,10,57
687,Chandler Parsons,1,SF,63,57,1804,248,549,0.452,60,178,0.337,188,371,0.507,0.506,43,78,0.551,90,210,300,134,73,29,81,142,599
687,Chandler Parsons,2,SF,76,76,2758,456,939,0.486,152,395,0.385,304,544,0.559,0.567,113,155,0.729,79,325,404,269,75,32,147,148,1177
687,Chandler Parsons,3,SF,74,74,2783,466,987,0.472,130,351,0.37,336,636,0.528,0.538,164,221,0.742,69,340,409,298,88,29,144,168,1226
687,Chandler Parsons,4,SF,66,66,2186,383,829,0.462,132,347,0.38,251,482,0.521,0.542,139,193,0.72,64,259,323,161,69,19,96,140,1037
688,Jeremy Tyler,1,C,42,23,568,88,209,0.421,0,1,0,88,208,0.423,0.421,29,52,0.558,54,86,140,16,16,20,36,84,205
688,Jeremy Tyler,2,C,21,0,68,9,24,0.375,0,0,,9,24,0.375,0.375,4,6,0.667,6,14,20,1,1,2,6,10,22
688,Jeremy Tyler,3,C,20,0,63,9,24,0.375,0,0,,9,24,0.375,0.375,4,6,0.667,6,11,17,1,1,2,6,10,22
688,Jeremy Tyler,4,C,1,0,5,0,0,,0,0,,0,0,,,0,0,,0,3,3,0,0,0,0,0,0
689,Jon Leuer,1,PF,46,12,555,97,191,0.508,3,9,0.333,94,182,0.516,0.516,21,28,0.75,45,75,120,25,14,17,18,67,218
689,Jon Leuer,2,PF-C,28,0,187,25,52,0.481,0,3,0,25,49,0.51,0.481,6,13,0.462,13,24,37,8,6,0,8,21,56
689,Jon Leuer,3,C,9,0,91,10,28,0.357,0,3,0,10,25,0.4,0.357,2,6,0.333,5,8,13,5,2,0,5,11,22
689,Jon Leuer,4,PF,19,0,96,15,24,0.625,0,0,,15,24,0.625,0.625,4,7,0.571,8,16,24,3,4,0,3,10,34
690,Darius Morris,1,PG,19,0,169,18,42,0.429,4,9,0.444,14,33,0.424,0.476,6,9,0.667,2,14,16,21,2,0,19,16,46
690,Darius Morris,2,PG,48,17,683,73,188,0.388,24,66,0.364,49,122,0.402,0.452,24,37,0.649,24,33,57,76,21,2,45,58,194
690,Darius Morris,3,PG,27,0,313,39,96,0.406,12,38,0.316,27,58,0.466,0.469,17,26,0.654,7,19,26,44,13,0,27,33,107
690,Darius Morris,4,PG,12,0,193,29,67,0.433,10,24,0.417,19,43,0.442,0.507,15,21,0.714,3,10,13,31,8,0,19,21,83
691,Davis Bertans,1,PF,67,6,808,103,234,0.44,69,173,0.399,34,61,0.557,0.588,28,34,0.824,22,76,98,46,20,28,32,75,303
691,Davis Bertans,2,PF,77,10,1086,161,366,0.44,94,252,0.373,67,114,0.588,0.568,40,49,0.816,18,135,153,74,26,28,36,93,456
691,Davis Bertans,3,PF,69,12,1492,183,408,0.449,135,308,0.438,48,100,0.48,0.614,47,54,0.87,23,223,246,87,31,33,36,121,548
692,Malcolm Lee,1,SG,19,0,243,23,59,0.39,2,10,0.2,21,49,0.429,0.407,14,17,0.824,9,17,26,31,8,4,17,22,62
692,Malcolm Lee,2,SG,16,12,289,29,76,0.382,8,24,0.333,21,52,0.404,0.434,12,20,0.6,15,24,39,20,12,6,10,30,78
692,Malcolm Lee,3,SG,1,0,2,0,1,0,0,0,,0,1,0,0,0,0,,0,0,0,0,0,0,0,0,0
693,Charles Jenkins,1,PG,51,28,893,130,291,0.447,3,20,0.15,127,271,0.469,0.452,34,39,0.872,8,60,68,170,33,6,60,85,297
693,Charles Jenkins,2,SG-PG,59,1,441,49,121,0.405,1,2,0.5,48,119,0.403,0.409,12,22,0.545,8,24,32,44,15,2,21,22,111
693,Charles Jenkins,3,SG,47,0,291,35,83,0.422,1,2,0.5,34,81,0.42,0.428,10,18,0.556,5,16,21,28,9,1,19,18,81
693,Charles Jenkins,4,PG,12,1,150,14,38,0.368,0,0,,14,38,0.368,0.368,2,4,0.5,3,8,11,16,6,1,2,4,30
694,Josh Harrellson,1,PF,37,4,540,63,149,0.423,20,59,0.339,43,90,0.478,0.49,16,26,0.615,47,97,144,11,23,20,20,48,162
694,Josh Harrellson,2,C,6,0,31,4,9,0.444,1,5,0.2,3,4,0.75,0.5,1,2,0.5,3,4,7,0,1,1,3,4,10
694,Josh Harrellson,3,C,32,0,317,38,82,0.463,12,31,0.387,26,51,0.51,0.537,5,7,0.714,30,46,76,15,6,15,10,44,93
695,Andrew Goudelock,1,SG,40,0,419,68,174,0.391,28,75,0.373,40,99,0.404,0.471,11,12,0.917,5,26,31,20,4,0,21,32,175
695,Andrew Goudelock,2,SG,1,0,6,0,2,0,0,0,,0,2,0,0,0,0,,1,0,1,0,0,0,0,0,0
695,Andrew Goudelock,3,PG,8,0,50,9,20,0.45,1,9,0.111,8,11,0.727,0.475,3,4,0.75,1,1,2,4,6,2,7,4,22
696,Travis Leslie,1,SG,10,0,45,5,14,0.357,0,0,,5,14,0.357,0.357,4,9,0.444,6,3,9,5,2,2,2,4,14
697,Keith Benson,1,C,3,0,9,0,1,0,0,0,,0,1,0,0,0,0,,2,1,3,0,0,0,0,0,0
698,Josh Selby,1,PG,28,0,237,25,72,0.347,2,15,0.133,23,57,0.404,0.361,11,14,0.786,2,13,15,30,7,0,29,17,63
698,Josh Selby,2,PG,10,0,59,6,22,0.273,1,6,0.167,5,16,0.313,0.295,7,11,0.636,0,5,5,4,2,0,7,7,20
699,Lavoy Allen,1,PF,41,15,624,79,167,0.473,0,0,,79,167,0.473,0.473,11,14,0.786,47,124,171,34,13,18,20,73,169
699,Lavoy Allen,2,C,79,37,1669,206,454,0.454,0,1,0,206,453,0.455,0.454,43,60,0.717,159,236,395,73,24,55,55,180,455
699,Lavoy Allen,3,PF,65,2,1072,134,300,0.447,2,13,0.154,132,287,0.46,0.45,33,50,0.66,119,192,311,71,24,33,44,126,303
699,Lavoy Allen,4,PF,51,2,960,117,266,0.44,2,13,0.154,115,253,0.455,0.444,27,40,0.675,106,171,277,65,22,27,40,115,263
700,Jon Diebler,No NBA Data,,,,,,,,,,,,,,,,,,,,,,,,,,
701,Vernon Macklin,1,C,23,0,135,19,35,0.543,0,0,,19,35,0.543,0.543,8,14,0.571,14,20,34,5,4,4,3,9,46
702,DeAndre Liggins,1,SF,17,0,115,12,25,0.48,0,4,0,12,21,0.571,0.48,9,19,0.474,6,9,15,5,6,0,10,6,33
702,DeAndre Liggins,2,SG,39,1,290,21,47,0.447,7,19,0.368,14,28,0.5,0.521,9,18,0.5,13,40,53,15,18,3,14,33,58
702,DeAndre Liggins,3,SG,1,0,1,1,1,1,0,0,,1,1,1,1,0,0,,1,0,1,0,0,0,0,0,2
702,DeAndre Liggins,4,SG,62,19,777,55,142,0.387,17,46,0.37,38,96,0.396,0.447,25,40,0.625,20,88,108,54,47,14,42,81,152
703,Milan Macvan,No NBA Data,,,,,,,,,,,,,,,,,,,,,,,,,,
704,E'Twaun Moore,1,PG,38,0,331,43,113,0.381,17,45,0.378,26,68,0.382,0.456,7,7,1,4,29,33,34,11,3,21,33,110
704,E'Twaun Moore,2,SG,75,21,1682,237,598,0.396,67,197,0.34,170,401,0.424,0.452,47,59,0.797,48,119,167,206,51,23,105,122,588
704,E'Twaun Moore,3,SG,79,3,1506,195,456,0.428,57,161,0.354,138,295,0.468,0.49,52,68,0.765,29,107,136,112,60,13,55,106,499
704,E'Twaun Moore,4,SG,56,0,504,62,139,0.446,13,38,0.342,49,101,0.485,0.493,12,20,0.6,12,34,46,33,20,6,14,45,149
705,Chukwudiebere Maduabum,No NBA Data,,,,,,,,,,,,,,,,,,,,,,,,,,
706,Targuy Ngombo,No NBA Data,,,,,,,,,,,,,,,,,,,,,,,,,,
707,Ater Majok,No NBA Data,,,,,,,,,,,,,,,,,,,,,,,,,,
708,Adam Hanga,No NBA Data,,,,,,,,,,,,,,,,,,,,,,,,,,
709,Isaiah Thomas,1,PG,65,37,1656,256,571,0.448,83,219,0.379,173,352,0.491,0.521,154,185,0.832,48,120,168,266,53,8,105,121,749
709,Isaiah Thomas,2,PG,79,62,2122,366,832,0.44,115,321,0.358,251,511,0.491,0.509,253,287,0.882,29,132,161,316,67,3,140,167,1100
709,Isaiah Thomas,3,PG,72,54,2497,496,1096,0.453,127,364,0.349,369,732,0.504,0.51,346,407,0.85,47,163,210,454,93,8,213,185,1465
709,Isaiah Thomas,4,PG,67,1,1726,335,797,0.42,129,346,0.373,206,451,0.457,0.501,302,348,0.868,33,120,153,284,57,5,143,150,1101
710,Anthony Davis,1,PF,64,60,1846,349,676,0.516,0,6,0,349,670,0.521,0.516,169,225,0.751,165,357,522,63,75,112,89,158,867
710,Anthony Davis,2,PF,67,66,2358,522,1005,0.519,2,9,0.222,520,996,0.522,0.52,348,440,0.791,207,466,673,105,89,189,109,200,1394
710,Anthony Davis,3,PF,68,68,2455,642,1199,0.535,1,12,0.083,641,1187,0.54,0.536,371,461,0.805,173,523,696,149,100,200,95,141,1656
710,Anthony Davis,4,C,61,61,2164,560,1136,0.493,35,108,0.324,525,1028,0.511,0.508,326,430,0.758,130,497,627,116,78,125,121,148,1481
711,Michael Kidd-Gilchrist,1,SF,78,77,2025,281,613,0.458,2,9,0.222,279,604,0.462,0.46,140,187,0.749,131,324,455,117,54,70,101,164,704
711,Michael Kidd-Gilchrist,2,SF,62,62,1502,167,353,0.473,1,9,0.111,166,344,0.483,0.475,113,184,0.614,109,215,324,52,43,39,60,145,448
711,Michael Kidd-Gilchrist,3,SF,55,52,1587,224,482,0.465,0,0,,224,482,0.465,0.465,150,214,0.701,109,307,416,77,30,38,63,115,598
711,Michael Kidd-Gilchrist,4,SF,7,7,205,33,61,0.541,3,7,0.429,30,54,0.556,0.566,20,29,0.69,12,33,45,9,3,3,8,9,89
712,Bradley Beal,1,SG,56,46,1745,282,687,0.41,91,236,0.386,191,451,0.424,0.477,125,159,0.786,43,168,211,137,50,29,90,113,780
712,Bradley Beal,2,SG,73,73,2530,481,1149,0.419,138,343,0.402,343,806,0.426,0.479,149,189,0.788,54,219,273,243,71,18,128,153,1249
712,Bradley Beal,3,SG,63,59,2107,363,851,0.427,106,259,0.409,257,592,0.434,0.489,130,166,0.783,57,184,241,194,76,18,123,136,962
712,Bradley Beal,4,SG,55,35,1708,359,799,0.449,105,271,0.387,254,528,0.481,0.515,135,176,0.767,41,147,188,162,54,11,112,117,958
713,Dion Waiters,1,SG,61,48,1756,336,815,0.412,63,203,0.31,273,612,0.446,0.451,159,213,0.746,22,127,149,183,59,16,121,113,894
713,Dion Waiters,2,SG,70,24,2072,430,993,0.433,92,250,0.368,338,743,0.455,0.479,161,235,0.685,32,163,195,209,63,17,154,153,1113
713,Dion Waiters,3,SG,80,23,2208,375,946,0.396,73,246,0.297,302,700,0.431,0.435,117,172,0.68,41,151,192,163,90,21,113,155,940
713,Dion Waiters,4,SG,33,3,786,138,342,0.404,22,86,0.256,116,256,0.453,0.436,47,60,0.783,12,45,57,74,44,10,50,59,345
714,Thomas Robinson,1,PF,70,0,1056,138,321,0.43,0,1,0,138,320,0.431,0.43,57,109,0.523,122,193,315,46,41,26,88,124,333
714,Thomas Robinson,2,PF,51,0,809,103,243,0.424,0,0,,103,243,0.424,0.424,41,71,0.577,92,146,238,36,25,21,65,95,247
714,Thomas Robinson,3,PF,19,0,247,35,78,0.449,0,1,0,35,77,0.455,0.449,16,38,0.421,30,47,77,10,16,5,23,29,86
714,Thomas Robinson,4,PF,70,0,873,141,293,0.481,0,1,0,141,292,0.483,0.481,57,101,0.564,105,202,307,34,23,20,57,131,339
715,Damian Lillard,1,PG,82,82,3167,553,1288,0.429,185,503,0.368,368,785,0.469,0.501,271,321,0.844,42,215,257,531,74,19,243,172,1562
715,Damian Lillard,2,PG,82,82,2937,553,1304,0.424,218,554,0.394,335,750,0.447,0.508,371,426,0.871,35,253,288,457,64,22,193,197,1695
715,Damian Lillard,3,PG,82,82,2925,590,1360,0.434,196,572,0.343,394,788,0.5,0.506,344,398,0.864,49,329,378,507,97,21,222,164,1720
715,Damian Lillard,4,PG,75,75,2676,618,1474,0.419,229,610,0.375,389,864,0.45,0.497,414,464,0.892,45,257,302,512,65,28,242,165,1879
716,Harrison Barnes,1,SF,81,81,2058,276,628,0.439,52,145,0.359,224,483,0.464,0.481,144,190,0.758,53,280,333,98,52,14,101,140,748
716,Harrison Barnes,2,SF,78,24,2204,271,679,0.399,66,190,0.347,205,489,0.419,0.448,130,181,0.718,66,245,311,116,65,20,84,158,738
716,Harrison Barnes,3,SF,82,82,2318,316,656,0.482,87,215,0.405,229,441,0.519,0.548,108,150,0.72,117,336,453,116,61,19,71,146,827
716,Harrison Barnes,4,SF,66,59,2042,295,633,0.466,82,214,0.383,213,419,0.508,0.531,102,134,0.761,77,248,325,117,41,10,57,136,774
717,Terrence Ross,1,SG,73,2,1239,186,457,0.407,65,196,0.332,121,261,0.464,0.478,30,42,0.714,35,109,144,53,43,14,48,122,467
717,Terrence Ross,2,SG,81,62,2159,318,751,0.423,161,408,0.395,157,343,0.458,0.531,82,98,0.837,43,209,252,79,64,27,88,183,879
717,Terrence Ross,3,SF,82,61,2092,309,753,0.41,145,390,0.372,164,363,0.452,0.507,44,56,0.786,32,194,226,86,53,25,69,136,807
717,Terrence Ross,4,SF,73,7,1747,270,626,0.431,131,339,0.386,139,287,0.484,0.536,49,62,0.79,21,164,185,56,54,25,46,120,720
718,Andre Drummond,1,C,60,10,1243,208,342,0.608,1,2,0.5,207,340,0.609,0.61,59,159,0.371,169,288,457,30,59,95,57,144,476
718,Andre Drummond,2,C,81,81,2619,479,769,0.623,0,2,0,479,767,0.625,0.623,137,328,0.418,440,631,1071,35,101,131,110,273,1095
718,Andre Drummond,3,C,82,82,2502,494,961,0.514,0,2,0,494,959,0.515,0.514,142,365,0.389,437,667,1104,55,73,153,120,285,1130
718,Andre Drummond,4,C,81,81,2666,552,1060,0.521,2,6,0.333,550,1054,0.522,0.522,208,586,0.355,395,803,1198,67,119,112,155,245,1314
719,Austin Rivers,1,SG,61,26,1418,145,390,0.372,28,86,0.326,117,304,0.385,0.408,59,108,0.546,16,93,109,127,26,9,74,122,377
719,Austin Rivers,2,PG,69,4,1339,192,474,0.405,36,99,0.364,156,375,0.416,0.443,110,173,0.636,26,103,129,160,45,9,77,134,530
719,Austin Rivers,3,PG-SG,76,5,1563,203,496,0.409,39,131,0.298,164,365,0.449,0.449,85,126,0.675,27,125,152,155,48,14,65,146,530
719,Austin Rivers,4,SG,35,3,772,86,222,0.387,14,50,0.28,72,172,0.419,0.419,53,71,0.746,12,56,68,87,18,7,30,65,239
720,Meyers Leonard,1,C,69,9,1206,151,277,0.545,3,7,0.429,148,270,0.548,0.551,72,89,0.809,80,175,255,33,11,38,49,168,377
720,Meyers Leonard,2,C,40,0,355,41,91,0.451,0,6,0,41,85,0.482,0.451,16,21,0.762,26,85,111,18,7,5,15,76,98
720,Meyers Leonard,3,C,55,7,847,125,245,0.51,47,112,0.42,78,133,0.586,0.606,30,32,0.938,46,204,250,32,10,14,39,113,327
720,Meyers Leonard,4,PF,61,10,1333,195,435,0.448,86,228,0.377,109,207,0.527,0.547,35,46,0.761,51,263,314,92,8,18,77,183,511
721,Jeremy Lamb,1,SF,23,0,147,24,68,0.353,9,30,0.3,15,38,0.395,0.419,14,14,1,5,13,18,5,2,2,6,13,71
721,Jeremy Lamb,2,SG,78,0,1538,263,609,0.432,88,247,0.356,175,362,0.483,0.504,51,64,0.797,27,162,189,115,56,26,61,143,665
721,Jeremy Lamb,3,SG,47,8,633,104,250,0.416,38,111,0.342,66,139,0.475,0.492,49,55,0.891,8,99,107,44,21,6,27,52,295
721,Jeremy Lamb,4,SG,66,0,1227,230,510,0.451,56,181,0.309,174,329,0.529,0.506,64,88,0.727,44,208,252,77,42,30,50,105,580
722,Kendall Marshall,1,PG,48,3,702,56,151,0.371,23,73,0.315,33,78,0.423,0.447,8,14,0.571,4,38,42,143,22,4,57,48,143
722,Kendall Marshall,2,PG,54,45,1564,170,419,0.406,71,178,0.399,99,241,0.411,0.49,19,36,0.528,15,140,155,477,48,4,150,76,430
722,Kendall Marshall,3,PG,28,3,417,46,101,0.455,18,46,0.391,28,55,0.509,0.545,8,9,0.889,2,26,28,86,21,0,35,26,118
722,Kendall Marshall,4,PG,30,6,400,43,118,0.364,16,49,0.327,27,69,0.391,0.432,9,13,0.692,2,26,28,73,16,2,43,30,111
723,John Henson,1,PF,63,9,827,162,336,0.482,0,3,0,162,333,0.486,0.482,56,105,0.533,116,181,297,31,19,42,47,83,380
723,John Henson,2,PF,70,23,1856,344,639,0.538,0,1,0,344,638,0.539,0.538,91,177,0.514,171,326,497,113,41,116,114,185,779
723,John Henson,3,C,67,11,1228,196,346,0.566,0,0,,196,346,0.566,0.566,78,137,0.569,124,188,312,59,28,135,87,152,470
723,John Henson,4,C,57,1,960,164,291,0.564,0,1,0,164,290,0.566,0.564,69,117,0.59,87,134,221,54,18,109,64,131,397
724,Maurice Harkless,1,SF,76,59,1974,260,564,0.461,32,117,0.274,228,447,0.51,0.489,73,128,0.57,122,213,335,50,88,62,69,144,625
724,Maurice Harkless,2,SF,80,41,1950,224,483,0.464,59,154,0.383,165,329,0.502,0.525,85,143,0.594,69,195,264,80,97,50,86,140,592
724,Maurice Harkless,3,SF,45,4,674,63,158,0.399,10,56,0.179,53,102,0.52,0.43,22,41,0.537,38,68,106,25,32,9,27,66,158
724,Maurice Harkless,4,SF,78,14,1457,195,411,0.474,39,140,0.279,156,271,0.576,0.522,69,111,0.622,101,179,280,67,49,35,62,124,498
725,Royce White,1,PF,3,0,9,0,1,0,0,0,,0,1,0,0,0,0,,0,0,0,0,0,0,0,2,0
726,Tyler Zeller,1,C,77,55,2033,245,559,0.438,0,4,0,245,555,0.441,0.438,120,157,0.764,159,279,438,96,35,70,95,251,610
726,Tyler Zeller,2,C,70,9,1049,156,290,0.538,0,1,0,156,289,0.54,0.538,87,121,0.719,103,179,282,36,18,38,60,137,399
726,Tyler Zeller,3,C,82,59,1731,340,619,0.549,0,0,,340,619,0.549,0.549,153,186,0.823,146,319,465,113,18,52,76,205,833
726,Tyler Zeller,4,C,60,3,710,138,290,0.476,0,0,,138,290,0.476,0.476,88,108,0.815,62,116,178,29,10,22,46,97,364
727,Terrence Jones,1,PF,19,0,276,43,94,0.457,5,19,0.263,38,75,0.507,0.484,13,17,0.765,28,37,65,15,12,19,13,21,104
727,Terrence Jones,2,PF,76,71,2078,386,712,0.542,31,101,0.307,355,611,0.581,0.564,118,195,0.605,162,366,528,87,53,99,71,139,921
727,Terrence Jones,3,PF,33,24,889,158,299,0.528,13,37,0.351,145,262,0.553,0.55,57,94,0.606,78,142,220,36,18,59,37,78,386
727,Terrence Jones,4,PF,50,11,1044,166,367,0.452,25,79,0.316,141,288,0.49,0.486,77,116,0.664,62,149,211,41,23,39,49,86,434
728,Andrew Nicholson,1,PF,75,28,1249,256,486,0.527,0,0,,256,486,0.527,0.527,75,94,0.798,69,189,258,44,24,32,79,133,587
728,Andrew Nicholson,2,PF,76,5,1174,180,420,0.429,28,89,0.315,152,331,0.459,0.462,47,57,0.825,53,202,255,25,18,23,51,150,435
728,Andrew Nicholson,3,PF,40,3,492,83,190,0.437,13,41,0.317,70,149,0.47,0.471,15,25,0.6,17,65,82,22,6,12,24,51,194
728,Andrew Nicholson,4,PF,56,0,823,146,310,0.471,41,114,0.36,105,196,0.536,0.537,51,65,0.785,34,167,201,25,10,22,41,69,384
729,Evan Fournier,1,SG,38,4,428,75,152,0.493,22,54,0.407,53,98,0.541,0.566,30,39,0.769,6,29,35,44,19,1,32,65,202
729,Evan Fournier,2,SG,76,4,1503,228,544,0.419,89,237,0.376,139,307,0.453,0.501,93,123,0.756,34,168,202,112,34,7,100,179,638
729,Evan Fournier,3,SG,58,32,1661,253,575,0.44,85,225,0.378,168,350,0.48,0.514,107,147,0.728,28,125,153,120,40,2,82,116,698
729,Evan Fournier,4,SF,79,71,2566,429,929,0.462,156,390,0.4,273,539,0.506,0.546,199,238,0.836,33,192,225,213,96,2,133,214,1213
730,Jared Sullinger,1,PF,45,5,892,111,225,0.493,1,5,0.2,110,220,0.5,0.496,47,63,0.746,92,172,264,35,22,22,29,154,270
730,Jared Sullinger,2,PF,74,44,2041,384,899,0.427,56,208,0.269,328,691,0.475,0.458,158,203,0.778,241,360,601,118,35,49,119,251,982
730,Jared Sullinger,3,PF,58,49,1566,311,708,0.439,52,184,0.283,259,524,0.494,0.476,96,129,0.744,147,294,441,134,44,42,78,153,770
730,Jared Sullinger,4,PF,81,73,1915,351,806,0.435,29,103,0.282,322,703,0.458,0.453,103,161,0.64,194,479,673,187,75,47,102,209,834
731,Fab Melo,1,C,6,0,36,3,6,0.5,0,0,,3,6,0.5,0.5,1,4,0.25,0,3,3,0,2,2,1,7,7
732,John Jenkins,1,SG,61,2,902,131,294,0.446,53,138,0.384,78,156,0.5,0.536,59,70,0.843,17,77,94,56,12,10,40,37,374
732,John Jenkins,2,SG,13,0,158,16,42,0.381,4,18,0.222,12,24,0.5,0.429,4,4,1,3,19,22,11,1,1,11,11,40
732,John Jenkins,3,SG,24,3,297,49,99,0.495,21,52,0.404,28,47,0.596,0.601,16,19,0.842,2,37,39,13,10,0,8,15,135
732,John Jenkins,4,SG,43,3,480,71,160,0.444,16,51,0.314,55,109,0.505,0.494,20,24,0.833,8,49,57,35,8,1,27,22,178
733,Jared Cunningham,1,SG,8,0,26,6,14,0.429,2,3,0.667,4,11,0.364,0.5,2,2,1,1,2,3,1,1,0,2,3,16
733,Jared Cunningham,2,SG,13,0,80,6,21,0.286,1,7,0.143,5,14,0.357,0.31,13,16,0.813,1,5,6,8,3,0,2,16,26
733,Jared Cunningham,3,SG,5,0,22,1,2,0.5,0,1,0,1,1,1,0.5,0,2,0,0,1,1,3,0,0,2,3,2
733,Jared Cunningham,4,SG,8,0,58,5,19,0.263,1,6,0.167,4,13,0.308,0.289,13,14,0.929,1,4,5,5,3,0,0,13,24
734,Tony Wroten,1,SG,35,0,272,33,86,0.384,4,16,0.25,29,70,0.414,0.407,21,29,0.724,13,15,28,43,8,4,29,34,91
734,Tony Wroten,2,PG,72,16,1765,345,808,0.427,40,188,0.213,305,620,0.492,0.452,209,326,0.641,69,159,228,217,78,16,204,151,939
734,Tony Wroten,3,PG,30,15,895,175,434,0.403,37,142,0.261,138,292,0.473,0.446,120,180,0.667,22,64,86,157,48,8,113,72,507
734,Tony Wroten,4,PG,8,3,144,22,65,0.338,3,17,0.176,19,48,0.396,0.362,20,37,0.541,2,19,21,20,3,0,29,11,67
735,Miles Plumlee,1,C,14,0,55,5,21,0.238,0,0,,5,21,0.238,0.238,3,4,0.75,12,10,22,2,0,3,3,5,13
735,Miles Plumlee,2,C,80,79,1964,286,553,0.517,0,0,,286,553,0.517,0.517,74,132,0.561,198,428,626,43,50,90,111,185,646
735,Miles Plumlee,3,C,73,28,1194,136,254,0.535,0,0,,136,254,0.535,0.535,22,46,0.478,112,208,320,34,41,66,51,111,294
735,Miles Plumlee,4,C,54,28,1005,107,195,0.549,0,0,,107,195,0.549,0.549,19,38,0.5,95,179,274,27,35,55,45,99,233
736,Arnett Moultrie,1,PF,47,0,542,78,134,0.582,0,0,,78,134,0.582,0.582,18,28,0.643,76,69,145,10,17,10,19,43,174
736,Arnett Moultrie,2,PF,12,2,187,16,38,0.421,0,0,,16,38,0.421,0.421,4,5,0.8,11,24,35,2,8,4,7,22,36
737,Perry Jones,1,SF,38,1,280,39,99,0.394,0,2,0,39,97,0.402,0.394,10,15,0.667,12,50,62,10,5,6,15,23,88
737,Perry Jones,2,PF,62,7,764,83,181,0.459,22,61,0.361,61,120,0.508,0.519,28,42,0.667,28,86,114,26,14,19,21,62,216
737,Perry Jones,3,SF,43,13,631,73,184,0.397,14,60,0.233,59,124,0.476,0.435,24,37,0.649,6,70,76,18,17,8,24,50,184
738,Marquis Teague,1,PG,48,0,392,43,113,0.381,4,23,0.174,39,90,0.433,0.398,9,16,0.563,3,41,44,63,9,7,35,47,99
738,Marquis Teague,2,SG,40,3,443,38,119,0.319,5,18,0.278,33,101,0.327,0.34,26,35,0.743,1,39,40,58,10,5,39,46,107
738,Marquis Teague,3,SG,19,2,242,16,66,0.242,2,10,0.2,14,56,0.25,0.258,11,16,0.688,1,18,19,28,2,4,17,25,45
738,Marquis Teague,4,SG,21,1,201,22,53,0.415,3,8,0.375,19,45,0.422,0.443,15,19,0.789,0,21,21,30,8,1,22,21,62
739,Festus Ezeli,1,C,78,41,1120,74,169,0.438,0,0,,74,169,0.438,0.438,43,81,0.531,141,172,313,22,23,74,63,157,191
739,Festus Ezeli,2,C,46,7,504,76,139,0.547,0,0,,76,139,0.547,0.547,49,78,0.628,60,95,155,9,7,42,32,77,201
739,Festus Ezeli,3,C,46,13,770,125,228,0.548,0,0,,125,228,0.548,0.548,70,132,0.53,91,166,257,32,18,50,38,94,320
740,Jeff Taylor,1,SF,77,29,1507,172,399,0.431,53,154,0.344,119,245,0.486,0.497,75,103,0.728,51,99,150,63,47,15,48,136,472
740,Jeff Taylor,2,SF,26,8,629,82,218,0.376,18,67,0.269,64,151,0.424,0.417,26,47,0.553,15,45,60,22,13,5,25,62,208
740,Jeff Taylor,3,SF,29,13,430,45,114,0.395,11,36,0.306,34,78,0.436,0.443,26,41,0.634,14,39,53,22,12,1,19,36,127
741,Tomas Satoransky,1,SG,57,3,719,61,147,0.415,9,37,0.243,52,110,0.473,0.446,23,33,0.697,25,58,83,92,26,6,38,60,154
741,Tomas Satoransky,2,SG,73,30,1643,201,384,0.523,47,101,0.465,154,283,0.544,0.585,75,96,0.781,72,161,233,286,52,15,83,131,524
741,Tomas Satoransky,3,SG,73,47,1954,237,484,0.49,59,149,0.396,178,335,0.531,0.551,108,131,0.824,76,182,258,364,74,13,107,164,641
742,Bernard James,1,C,46,11,457,53,103,0.515,0,2,0,53,101,0.525,0.515,25,41,0.61,52,79,131,6,12,38,18,64,131
742,Bernard James,2,C,30,0,146,11,23,0.478,0,1,0,11,22,0.5,0.478,6,11,0.545,15,27,42,3,3,8,10,24,28
742,Bernard James,3,C,16,2,158,12,27,0.444,0,0,,12,27,0.444,0.444,20,23,0.87,18,21,39,4,2,15,6,17,44
743,Jae Crowder,1,SF,78,16,1353,141,367,0.384,63,192,0.328,78,175,0.446,0.47,47,73,0.644,35,152,187,94,63,17,49,128,392
743,Jae Crowder,2,SF,78,8,1254,130,296,0.439,50,151,0.331,80,145,0.552,0.524,46,61,0.754,46,148,194,60,59,21,41,100,356
743,Jae Crowder,3,SF,82,17,1647,229,545,0.42,61,208,0.293,168,337,0.499,0.476,109,141,0.773,72,221,293,94,72,25,49,137,628
743,Jae Crowder,4,SF,25,0,265,33,76,0.434,13,38,0.342,20,38,0.526,0.52,10,11,0.909,12,17,29,12,15,5,10,26,89
744,Draymond Green,1,SF,79,1,1061,84,257,0.327,14,67,0.209,70,190,0.368,0.354,45,55,0.818,58,202,260,53,42,25,51,159,227
744,Draymond Green,2,SF,82,12,1797,187,459,0.407,55,165,0.333,132,294,0.449,0.467,82,123,0.667,86,323,409,152,102,72,91,231,511
744,Draymond Green,3,PF,79,79,2490,339,765,0.443,111,329,0.337,228,436,0.523,0.516,132,200,0.66,114,533,647,291,123,99,133,253,921
744,Draymond Green,4,PF,81,81,2808,401,819,0.49,100,258,0.388,301,561,0.537,0.551,229,329,0.696,134,635,769,598,119,113,259,240,1131
745,Orlando Johnson,1,SG,51,0,619,72,180,0.4,36,94,0.383,36,86,0.419,0.5,23,32,0.719,20,90,110,47,11,9,29,51,203
745,Orlando Johnson,2,SG,45,0,392,36,113,0.319,9,47,0.191,27,66,0.409,0.358,19,26,0.731,9,46,55,20,6,2,15,26,100
745,Orlando Johnson,3,SG,38,0,342,33,96,0.344,8,41,0.195,25,55,0.455,0.385,17,22,0.773,7,44,51,16,6,1,14,23,91
745,Orlando Johnson,4,SG,7,0,50,3,17,0.176,1,6,0.167,2,11,0.182,0.206,2,4,0.5,2,2,4,4,0,1,1,3,9
746,Quincy Acy,1,PF,29,0,342,42,75,0.56,1,2,0.5,41,73,0.562,0.567,31,38,0.816,30,47,77,11,13,15,17,53,116
746,Quincy Acy,2,SF,63,0,847,66,141,0.468,4,15,0.267,62,126,0.492,0.482,35,53,0.66,72,144,216,28,23,26,30,122,171
746,Quincy Acy,3,SF,7,0,61,6,14,0.429,2,5,0.4,4,9,0.444,0.5,5,8,0.625,5,10,15,4,4,3,2,8,19
746,Quincy Acy,4,SF,56,0,786,60,127,0.472,2,10,0.2,58,117,0.496,0.48,30,45,0.667,67,134,201,24,19,23,28,114,152
747,Quincy Miller,1,PF,7,0,26,4,12,0.333,0,1,0,4,11,0.364,0.333,1,2,0.5,1,1,2,3,1,0,1,3,9
747,Quincy Miller,2,PF,52,16,789,94,256,0.367,30,94,0.319,64,162,0.395,0.426,39,55,0.709,36,111,147,26,22,32,48,70,257
747,Quincy Miller,3,PF,10,0,119,9,38,0.237,3,18,0.167,6,20,0.3,0.276,8,11,0.727,4,16,20,8,7,5,5,9,29
747,Quincy Miller,4,PF,6,0,61,4,18,0.222,1,7,0.143,3,11,0.273,0.25,8,11,0.727,2,10,12,3,6,3,3,4,17
748,Khris Middleton,1,SG,27,0,475,62,141,0.44,14,45,0.311,48,96,0.5,0.489,27,32,0.844,4,46,50,28,15,4,11,53,165
748,Khris Middleton,2,SF,82,64,2460,376,854,0.44,120,290,0.414,256,564,0.454,0.511,118,137,0.861,60,250,310,169,83,20,123,243,990
748,Khris Middleton,3,SF,79,58,2378,406,869,0.467,109,268,0.407,297,601,0.494,0.53,134,156,0.859,48,299,347,182,122,11,113,183,1055
748,Khris Middleton,4,SG,79,79,2852,507,1142,0.444,143,361,0.396,364,781,0.466,0.507,277,312,0.888,44,258,302,331,131,19,180,204,1434
749,Will Barton,1,SG,73,5,894,118,309,0.382,9,65,0.138,109,244,0.447,0.396,50,65,0.769,36,109,145,58,34,9,60,56,295
749,Will Barton,2,SG,41,0,387,65,156,0.417,10,33,0.303,55,123,0.447,0.449,26,32,0.813,16,58,74,33,9,7,18,31,166
749,Will Barton,3,SG,58,0,983,150,353,0.425,23,85,0.271,127,268,0.474,0.458,74,94,0.787,26,136,162,81,48,19,61,70,397
749,Will Barton,4,SG,30,0,300,38,100,0.38,4,18,0.222,34,82,0.415,0.4,10,15,0.667,3,31,34,27,14,4,17,20,90
750,Tyshawn Taylor,1,PG,38,0,221,32,87,0.368,6,13,0.462,26,74,0.351,0.402,15,27,0.556,2,16,18,21,13,0,25,25,85
750,Tyshawn Taylor,2,PG,23,3,270,31,91,0.341,3,12,0.25,28,79,0.354,0.357,24,30,0.8,3,12,15,36,12,1,31,29,89
751,Doron Lamb,1,SG,47,0,577,60,163,0.368,14,37,0.378,46,126,0.365,0.411,20,34,0.588,8,38,46,32,13,0,26,52,154
751,Doron Lamb,2,SG,23,0,280,33,95,0.347,4,16,0.25,29,79,0.367,0.368,8,15,0.533,3,14,17,20,7,0,16,27,78
751,Doron Lamb,3,SG,24,0,297,27,68,0.397,10,21,0.476,17,47,0.362,0.471,12,19,0.632,5,24,29,12,6,0,10,25,76
751,Doron Lamb,4,SG,53,0,695,63,160,0.394,36,90,0.4,27,70,0.386,0.506,29,36,0.806,8,41,49,43,11,1,27,54,191
752,Mike Scott,1,PF,40,1,376,70,147,0.476,0,1,0,70,146,0.479,0.476,43,56,0.768,39,71,110,12,4,2,21,32,183
752,Mike Scott,2,PF,80,6,1482,301,628,0.479,62,200,0.31,239,428,0.558,0.529,103,132,0.78,62,222,284,75,30,7,79,121,767
752,Mike Scott,3,PF,68,0,1123,201,453,0.444,66,192,0.344,135,261,0.517,0.517,61,77,0.792,45,154,199,75,25,3,39,83,529
752,Mike Scott,4,PF,75,0,1146,176,376,0.468,62,158,0.392,114,218,0.523,0.551,50,63,0.794,53,153,206,78,25,17,42,102,464
753,Kim English,1,SG,41,0,407,42,112,0.375,14,50,0.28,28,62,0.452,0.438,21,29,0.724,8,29,37,26,16,3,19,46,119
754,Justin Hamilton,1,C,8,0,72,9,20,0.45,3,9,0.333,6,11,0.545,0.525,5,5,1,4,3,7,0,5,0,4,8,26
754,Justin Hamilton,2,C,1,0,4,0,0,,0,0,,0,0,,,0,0,,0,0,0,0,1,0,1,0,0
754,Justin Hamilton,3,C,7,0,68,9,20,0.45,3,9,0.333,6,11,0.545,0.525,5,5,1,4,3,7,0,4,0,3,8,26
754,Justin Hamilton,4,C,41,14,712,85,178,0.478,10,31,0.323,75,147,0.51,0.506,39,47,0.83,57,77,134,36,27,30,26,70,219
755,Darius Miller,1,SF,52,2,694,44,108,0.407,22,56,0.393,22,52,0.423,0.509,8,8,1,8,70,78,44,17,12,23,89,118
755,Darius Miller,2,SF,45,7,723,73,166,0.44,25,77,0.325,48,89,0.539,0.515,29,36,0.806,9,43,52,43,24,9,22,88,200
755,Darius Miller,3,SF,5,1,43,1,7,0.143,0,1,0,1,6,0.167,0.143,0,0,,0,1,1,2,1,0,1,8,2
755,Darius Miller,4,SF,82,3,1944,216,487,0.444,147,358,0.411,69,129,0.535,0.594,58,67,0.866,18,146,164,111,28,17,58,160,637
756,Kevin Murphy,1,SG,17,0,52,7,28,0.25,1,5,0.2,6,23,0.261,0.268,0,0,,0,4,4,2,1,0,3,4,15
757,Kostas Papanikolaou,1,SF,43,1,795,69,197,0.35,31,106,0.292,38,91,0.418,0.429,13,18,0.722,39,79,118,85,29,13,55,71,182
757,Kostas Papanikolaou,2,SF,26,6,294,24,66,0.364,10,32,0.313,14,34,0.412,0.439,9,14,0.643,8,32,40,16,13,5,21,24,67
758,Kyle O'Quinn,1,C,57,5,638,101,197,0.513,0,1,0,101,196,0.515,0.513,30,45,0.667,65,144,209,52,11,26,37,107,232
758,Kyle O'Quinn,2,C,69,19,1188,186,371,0.501,0,3,0,186,368,0.505,0.501,57,83,0.687,100,264,364,78,39,88,78,165,429
758,Kyle O'Quinn,3,PF,51,17,824,119,242,0.492,12,43,0.279,107,199,0.538,0.517,44,57,0.772,46,153,199,59,31,39,55,110,294
758,Kyle O'Quinn,4,PF,65,1,764,129,271,0.476,5,22,0.227,124,249,0.498,0.485,46,60,0.767,76,174,250,72,20,49,61,107,309
759,Izzet Turkyilmaz,No NBA Data,,,,,,,,,,,,,,,,,,,,,,,,,,
760,Kris Joseph,1,SF,10,0,54,2,14,0.143,0,3,0,2,11,0.182,0.143,5,8,0.625,1,6,7,1,3,0,2,3,9
760,Kris Joseph,2,SF,6,0,24,2,11,0.182,0,2,0,2,9,0.222,0.182,3,4,0.75,1,4,5,1,0,0,2,2,7
760,Kris Joseph,3,SF,4,0,30,0,3,0,0,1,0,0,2,0,0,2,4,0.5,0,2,2,0,3,0,0,1,2
761,Ognjen Kuzmic,1,C,21,0,92,5,13,0.385,0,0,,5,13,0.385,0.385,5,11,0.455,10,11,21,2,3,4,10,17,15
761,Ognjen Kuzmic,2,C,16,0,72,8,12,0.667,0,0,,8,12,0.667,0.667,4,4,1,7,10,17,6,2,1,5,13,20
762,Furkan Aldemir,1,PF,41,9,540,40,78,0.513,0,5,0,40,73,0.548,0.513,13,27,0.481,78,98,176,28,17,16,17,96,93
763,Tornike Shengelia,1,SF,19,0,93,10,23,0.435,1,2,0.5,9,21,0.429,0.457,9,16,0.563,9,14,23,3,3,1,11,11,30
763,Tornike Shengelia,2,SF,26,0,154,13,28,0.464,0,6,0,13,22,0.591,0.464,3,8,0.375,4,12,16,14,3,1,12,18,29
763,Tornike Shengelia,3,SF,17,0,137,11,24,0.458,0,6,0,11,18,0.611,0.458,3,8,0.375,4,10,14,12,2,1,11,16,25
763,Tornike Shengelia,4,SF,9,0,17,2,4,0.5,0,0,,2,4,0.5,0.5,0,0,,0,2,2,2,1,0,1,2,4
764,Darius Johnson-Odom,1,SG,4,0,6,0,4,0,0,1,0,0,3,0,0,0,0,,1,3,4,1,0,0,0,0,0
764,Darius Johnson-Odom,2,SG,3,0,15,0,7,0,0,3,0,0,4,0,0,0,2,0,0,2,2,1,1,0,2,3,0
765,Tomislav Zubcic,No NBA Data,,,,,,,,,,,,,,,,,,,,,,,,,,
766,Ilkan Karaman,No NBA Data,,,,,,,,,,,,,,,,,,,,,,,,,,
767,Robbie Hummel,1,SF,53,5,655,67,177,0.379,32,89,0.36,35,88,0.398,0.469,15,16,0.938,35,97,132,23,16,2,10,57,181
767,Robbie Hummel,2,SF,45,4,742,79,172,0.459,16,51,0.314,63,121,0.521,0.506,24,29,0.828,31,103,134,27,16,9,18,86,198
768,Marcus Denmon,No NBA Data,,,,,,,,,,,,,,,,,,,,,,,,,,
769,Robert Sacre,1,C,32,3,203,18,48,0.375,0,0,,18,48,0.375,0.375,7,11,0.636,9,25,34,6,0,10,10,38,43
769,Robert Sacre,2,C,65,13,1089,143,300,0.477,0,0,,143,300,0.477,0.477,64,94,0.681,82,172,254,51,24,47,44,134,350
769,Robert Sacre,3,C,67,18,1133,126,306,0.412,0,1,0,126,305,0.413,0.412,55,82,0.671,89,144,233,55,28,43,36,121,307
769,Robert Sacre,4,C,25,1,320,31,75,0.413,0,0,,31,75,0.413,0.413,25,38,0.658,32,40,72,14,4,10,12,43,87
770,Anthony Bennett,1,PF,52,0,663,80,225,0.356,13,53,0.245,67,172,0.39,0.384,44,69,0.638,49,106,155,17,21,8,47,93,217
770,Anthony Bennett,2,PF,57,3,894,125,297,0.421,7,23,0.304,118,274,0.431,0.433,41,64,0.641,52,164,216,48,27,16,36,87,298
770,Anthony Bennett,3,PF,19,0,84,8,27,0.296,3,14,0.214,5,13,0.385,0.352,9,10,0.9,6,17,23,0,5,0,4,8,28
770,Anthony Bennett,4,PF,23,1,264,38,92,0.413,13,48,0.271,25,44,0.568,0.484,26,36,0.722,25,53,78,12,5,3,12,18,115
771,Victor Oladipo,1,PG,80,44,2487,392,936,0.419,74,226,0.327,318,710,0.448,0.458,248,318,0.78,43,286,329,327,129,37,256,210,1106
771,Victor Oladipo,2,SG,72,71,2573,473,1086,0.436,84,248,0.339,389,838,0.464,0.474,262,320,0.819,51,251,302,295,120,19,204,187,1292
771,Victor Oladipo,3,SG,72,52,2379,425,970,0.438,98,282,0.348,327,688,0.475,0.489,205,247,0.83,48,297,345,282,116,54,153,174,1153
771,Victor Oladipo,4,SG,67,67,2222,412,932,0.442,127,352,0.361,285,580,0.491,0.51,116,154,0.753,39,252,291,176,78,21,119,155,1067
772,Otto Porter,1,SF,37,0,319,33,91,0.363,4,21,0.19,29,70,0.414,0.385,8,12,0.667,21,36,57,10,8,1,14,26,78
772,Otto Porter,2,SF,74,13,1432,176,391,0.45,35,104,0.337,141,287,0.491,0.495,58,79,0.734,70,151,221,65,44,30,52,97,445
772,Otto Porter,3,SF,75,73,2276,339,717,0.473,98,267,0.367,241,450,0.536,0.541,95,126,0.754,97,294,391,120,105,32,70,163,871
772,Otto Porter,4,SF,80,80,2605,414,803,0.516,148,341,0.434,266,462,0.576,0.608,99,119,0.832,118,396,514,121,116,42,44,193,1075
773,Cody Zeller,1,C,82,3,1416,172,404,0.426,0,1,0,172,403,0.427,0.426,146,200,0.73,118,235,353,92,40,41,87,170,490
773,Cody Zeller,2,C,62,45,1487,172,373,0.461,1,1,1,171,372,0.46,0.462,127,164,0.774,97,265,362,100,34,49,62,156,472
773,Cody Zeller,3,C,73,60,1774,231,437,0.529,1,10,0.1,230,427,0.539,0.53,175,232,0.754,138,317,455,71,57,63,68,204,638
773,Cody Zeller,4,C,62,58,1725,253,443,0.571,0,1,0,253,442,0.572,0.571,133,196,0.679,135,270,405,99,62,58,65,189,639
774,Alex Len,1,C,42,3,362,33,78,0.423,0,0,,33,78,0.423,0.423,20,31,0.645,39,60,99,4,4,18,26,68,86
774,Alex Len,2,C,69,44,1518,179,353,0.507,1,3,0.333,178,350,0.509,0.508,73,104,0.702,142,312,454,32,34,105,74,213,432
774,Alex Len,3,C,78,46,1821,264,624,0.423,1,7,0.143,263,617,0.426,0.424,174,239,0.728,178,416,594,97,38,62,145,230,703
774,Alex Len,4,C,77,34,1560,230,463,0.497,3,12,0.25,227,451,0.503,0.5,150,208,0.721,156,354,510,44,38,98,102,242,613
775,Nerlens Noel,1,C,75,71,2311,302,653,0.462,0,0,,302,653,0.462,0.462,140,230,0.609,185,426,611,128,133,142,146,208,744
775,Nerlens Noel,2,C,67,62,1965,306,587,0.521,1,2,0.5,305,585,0.521,0.522,134,227,0.59,154,388,542,122,118,100,158,192,747
775,Nerlens Noel,3,C,51,19,1047,184,309,0.595,0,1,0,184,308,0.597,0.595,77,111,0.694,93,201,294,50,65,50,51,126,445
775,Nerlens Noel,4,C,29,7,564,107,175,0.611,0,1,0,107,174,0.615,0.611,43,63,0.683,46,98,144,30,43,26,29,71,257
776,Ben McLemore,1,SG,82,55,2187,255,679,0.376,95,297,0.32,160,382,0.419,0.446,115,143,0.804,53,182,235,82,45,18,96,201,720
776,Ben McLemore,2,SG,82,82,2670,363,831,0.437,140,391,0.358,223,440,0.507,0.521,130,160,0.813,31,210,241,140,77,19,138,219,996
776,Ben McLemore,3,SG,68,53,1443,195,455,0.429,67,185,0.362,128,270,0.474,0.502,74,103,0.718,34,114,148,79,52,10,99,140,531
776,Ben McLemore,4,SG,61,26,1176,180,419,0.43,65,170,0.382,115,249,0.462,0.507,70,93,0.753,19,110,129,51,29,6,62,108,495
777,Kentavious Caldwell-Pope,1,SG,80,41,1583,182,460,0.396,59,185,0.319,123,275,0.447,0.46,47,61,0.77,38,118,156,55,75,12,28,145,470
777,Kentavious Caldwell-Pope,2,SG,82,82,2587,390,972,0.401,153,444,0.345,237,528,0.449,0.48,110,158,0.696,46,209,255,109,93,18,94,161,1043
777,Kentavious Caldwell-Pope,3,SG,76,76,2789,403,960,0.42,114,369,0.309,289,591,0.489,0.479,185,228,0.811,70,212,282,138,110,17,105,167,1105
777,Kentavious Caldwell-Pope,4,SG,76,75,2529,370,928,0.399,153,437,0.35,217,491,0.442,0.481,154,185,0.832,55,193,248,193,89,12,86,118,1047
778,Trey Burke,1,PG,70,68,2262,341,897,0.38,111,336,0.33,230,561,0.41,0.442,102,113,0.903,37,171,208,396,42,6,131,145,895
778,Trey Burke,2,PG,76,43,2288,370,1005,0.368,124,390,0.318,246,615,0.4,0.43,109,145,0.752,31,173,204,328,65,15,124,119,973
778,Trey Burke,3,PG,64,0,1366,262,634,0.413,88,256,0.344,174,378,0.46,0.483,67,82,0.817,18,94,112,148,35,6,80,86,679
778,Trey Burke,4,PG,57,0,703,116,255,0.455,31,70,0.443,85,185,0.459,0.516,22,29,0.759,7,40,47,100,11,5,48,54,285
779,CJ McCollum,1,SG,38,0,476,74,178,0.416,30,80,0.375,44,98,0.449,0.5,23,34,0.676,7,41,48,27,14,2,35,53,201
779,CJ McCollum,2,SG,62,3,973,159,365,0.436,55,139,0.396,104,226,0.46,0.511,51,73,0.699,14,77,91,64,43,8,48,81,424
779,CJ McCollum,3,SG,80,80,2780,641,1431,0.448,197,472,0.417,444,959,0.463,0.517,187,226,0.827,47,212,259,341,97,23,196,187,1666
779,CJ McCollum,4,SG,80,80,2796,692,1441,0.48,185,439,0.421,507,1002,0.506,0.544,268,294,0.912,60,229,289,285,72,42,172,202,1837
780,Michael Carter-Williams,1,PG,70,70,2414,427,1054,0.405,55,208,0.264,372,846,0.44,0.431,258,367,0.703,101,336,437,441,130,43,247,213,1167
780,Michael Carter-Williams,2,PG,66,63,2149,364,919,0.396,36,153,0.235,328,766,0.428,0.416,202,291,0.694,64,289,353,442,111,30,253,167,966
780,Michael Carter-Williams,3,PG,41,38,1391,232,611,0.38,32,125,0.256,200,486,0.412,0.406,117,182,0.643,43,211,254,302,60,18,174,103,613
780,Michael Carter-Williams,4,PG,25,25,758,132,308,0.429,4,28,0.143,128,280,0.457,0.435,85,109,0.78,21,78,99,140,51,12,79,64,353
781,Steven Adams,1,C,81,20,1197,93,185,0.503,0,0,,93,185,0.503,0.503,79,136,0.581,142,190,332,43,40,57,71,203,265
781,Steven Adams,2,C,70,67,1771,217,399,0.544,0,2,0,217,397,0.547,0.544,103,205,0.502,199,324,523,66,38,86,99,222,537
781,Steven Adams,3,C,80,80,2014,261,426,0.613,0,0,,261,426,0.613,0.613,114,196,0.582,219,314,533,62,42,89,84,223,636
781,Steven Adams,4,C,80,80,2389,374,655,0.571,0,1,0,374,654,0.572,0.571,157,257,0.611,281,332,613,86,89,78,146,195,905
782,Kelly Olynyk,1,C,70,9,1400,234,502,0.466,40,114,0.351,194,388,0.5,0.506,99,122,0.811,140,225,365,109,35,27,106,227,607
782,Kelly Olynyk,2,C,64,13,1423,251,528,0.475,61,175,0.349,190,353,0.538,0.533,93,136,0.684,92,211,303,109,64,39,98,213,656
782,Kelly Olynyk,3,C,69,8,1395,253,556,0.455,85,210,0.405,168,346,0.486,0.531,96,128,0.75,72,209,281,105,52,33,74,163,687
782,Kelly Olynyk,4,C,75,6,1538,260,508,0.512,68,192,0.354,192,316,0.608,0.579,90,123,0.732,73,288,361,148,43,29,96,207,678
783,Shabazz Muhammad,1,SG,37,0,290,57,124,0.46,3,11,0.273,54,113,0.478,0.472,26,40,0.65,24,29,53,6,8,1,16,24,143
783,Shabazz Muhammad,2,SG,38,13,866,194,397,0.489,20,51,0.392,174,346,0.503,0.514,104,145,0.717,63,91,154,44,18,7,35,49,512
783,Shabazz Muhammad,3,SF,82,0,1682,317,681,0.465,44,152,0.289,273,529,0.516,0.498,185,242,0.764,100,167,267,52,24,7,70,94,863
783,Shabazz Muhammad,4,SF,78,1,1516,288,598,0.482,49,145,0.338,239,453,0.528,0.523,147,190,0.774,84,136,220,35,22,6,56,86,772
784,Giannis Antetokounmpo,1,SF,77,23,1897,173,418,0.414,41,118,0.347,132,300,0.44,0.463,138,202,0.683,78,261,339,150,60,61,122,173,525
784,Giannis Antetokounmpo,2,SG,81,71,2541,383,780,0.491,7,44,0.159,376,736,0.511,0.496,257,347,0.741,100,442,542,207,73,85,173,254,1030
784,Giannis Antetokounmpo,3,PG,80,79,2823,513,1013,0.506,28,109,0.257,485,904,0.537,0.52,296,409,0.724,113,499,612,345,94,113,208,258,1350
784,Giannis Antetokounmpo,4,SF,80,80,2845,656,1259,0.521,49,180,0.272,607,1079,0.563,0.541,471,612,0.77,142,558,700,434,131,151,234,246,1832
785,Lucas Nogueira,1,C,6,0,23,2,8,0.25,0,0,,2,8,0.25,0.25,2,4,0.5,2,9,11,1,2,0,2,6,6
785,Lucas Nogueira,2,C,29,1,225,28,44,0.636,1,3,0.333,27,41,0.659,0.648,8,15,0.533,18,28,46,7,12,12,11,29,65
785,Lucas Nogueira,3,C,57,6,1088,103,156,0.66,3,12,0.25,100,144,0.694,0.67,44,67,0.657,82,162,244,42,52,89,46,137,253
785,Lucas Nogueira,4,C,49,3,418,49,80,0.613,5,19,0.263,44,61,0.721,0.644,19,28,0.679,18,69,87,22,23,43,16,49,122
786,Dennis Schroder,1,PG,49,0,641,72,188,0.383,10,42,0.238,62,146,0.425,0.41,29,43,0.674,5,55,60,93,17,0,61,54,183
786,Dennis Schroder,2,PG,77,10,1516,284,665,0.427,52,148,0.351,232,517,0.449,0.466,148,179,0.827,29,135,164,317,49,4,150,127,768
786,Dennis Schroder,3,PG,80,6,1621,329,781,0.421,77,239,0.322,252,542,0.465,0.471,144,182,0.791,25,179,204,349,70,9,183,138,879
786,Dennis Schroder,4,PG,79,78,2485,548,1214,0.451,100,294,0.34,448,920,0.487,0.493,218,255,0.855,42,206,248,499,74,16,258,149,1414
787,Shane Larkin,1,PG,48,0,489,52,137,0.38,12,38,0.316,40,99,0.404,0.423,16,25,0.64,11,31,42,71,26,1,39,46,132
787,Shane Larkin,2,PG,76,22,1865,187,432,0.433,35,116,0.302,152,316,0.481,0.473,61,78,0.782,29,147,176,226,93,9,83,150,470
787,Shane Larkin,3,PG,78,17,1751,222,502,0.442,39,108,0.361,183,394,0.464,0.481,83,107,0.776,28,152,180,342,95,12,146,121,566
787,Shane Larkin,4,PG,54,2,775,84,219,0.384,31,86,0.36,53,133,0.398,0.454,32,37,0.865,15,77,92,98,29,2,33,58,231
788,Sergey Karasev,1,SF,22,1,156,12,35,0.343,4,19,0.211,8,16,0.5,0.4,9,10,0.9,0,16,16,6,3,1,11,22,37
788,Sergey Karasev,2,SG,33,16,555,54,134,0.403,16,54,0.296,38,80,0.475,0.463,29,38,0.763,22,44,66,46,23,1,24,45,153
788,Sergey Karasev,3,SF,40,5,399,30,74,0.405,11,37,0.297,19,37,0.514,0.48,26,28,0.929,8,50,58,35,6,2,22,27,97
789,Tony Snell,1,SG,77,12,1231,129,336,0.384,57,178,0.32,72,158,0.456,0.469,31,41,0.756,19,105,124,68,29,15,44,84,346
789,Tony Snell,2,SF,72,22,1412,159,371,0.429,73,197,0.371,86,174,0.494,0.527,44,55,0.8,31,145,176,62,32,11,48,86,435
789,Tony Snell,3,SF,64,33,1301,126,339,0.372,56,155,0.361,70,184,0.38,0.454,30,33,0.909,19,180,199,63,16,17,52,100,338
789,Tony Snell,4,SG,80,80,2336,246,541,0.455,144,355,0.406,102,186,0.548,0.588,47,58,0.81,22,226,248,96,55,14,55,125,683
790,Gorgui Dieng,1,C,60,15,818,113,227,0.498,1,1,1,112,226,0.496,0.5,59,93,0.634,103,197,300,39,30,50,54,108,286
790,Gorgui Dieng,2,C,73,49,2193,259,512,0.506,1,6,0.167,258,506,0.51,0.507,191,244,0.783,223,386,609,146,71,126,126,188,710
790,Gorgui Dieng,3,C,82,39,2220,308,579,0.532,6,20,0.3,302,559,0.54,0.537,205,248,0.827,157,428,585,143,94,96,140,219,827
790,Gorgui Dieng,4,PF,82,82,2653,332,661,0.502,16,43,0.372,316,618,0.511,0.514,136,167,0.814,188,459,647,158,88,95,107,254,816
791,Mason Plumlee,1,C,70,22,1275,199,302,0.659,0,3,0,199,299,0.666,0.659,122,195,0.626,99,209,308,60,49,55,77,171,520
791,Mason Plumlee,2,C,82,45,1743,280,489,0.573,0,3,0,280,486,0.576,0.573,157,317,0.495,175,337,512,74,65,63,106,207,717
791,Mason Plumlee,3,C,82,82,2084,267,517,0.516,0,4,0,267,513,0.52,0.516,215,335,0.642,201,427,628,226,68,85,154,253,749
791,Mason Plumlee,4,C,81,64,2148,334,623,0.536,0,6,0,334,617,0.541,0.536,174,300,0.58,170,435,605,284,69,92,134,226,842
792,Solomon Hill,1,SF,28,0,226,17,40,0.425,7,23,0.304,10,17,0.588,0.513,6,7,0.857,9,32,41,12,5,2,13,19,47
792,Solomon Hill,2,SF,82,78,2381,251,634,0.396,68,208,0.327,183,426,0.43,0.45,159,193,0.824,70,244,314,184,66,18,115,177,729
792,Solomon Hill,3,SF,59,3,866,93,208,0.447,24,74,0.324,69,134,0.515,0.505,36,42,0.857,39,127,166,57,37,11,33,68,246
792,Solomon Hill,4,SF,80,71,2374,183,478,0.383,94,270,0.348,89,208,0.428,0.481,103,128,0.805,51,256,307,141,72,32,82,182,563
793,Tim Hardaway,1,SG,81,1,1875,294,687,0.428,130,358,0.363,164,329,0.498,0.523,106,128,0.828,19,102,121,66,44,7,47,144,824
793,Tim Hardaway,2,SG,70,30,1681,279,717,0.389,121,354,0.342,158,363,0.435,0.474,125,156,0.801,12,144,156,127,20,14,82,119,804
793,Tim Hardaway,3,SG,51,1,864,114,265,0.43,48,142,0.338,66,123,0.537,0.521,50,56,0.893,7,79,86,51,21,7,23,48,326
793,Tim Hardaway,4,SG,79,30,2154,415,912,0.455,149,417,0.357,266,495,0.537,0.537,164,214,0.766,35,189,224,182,55,15,106,103,1143
794,Reggie Bullock,1,SF,43,0,395,43,121,0.355,22,73,0.301,21,48,0.438,0.446,7,9,0.778,11,43,54,12,9,1,13,26,115
794,Reggie Bullock,2,SF,36,2,338,24,70,0.343,15,46,0.326,9,24,0.375,0.45,6,9,0.667,1,49,50,8,10,4,8,19,69
794,Reggie Bullock,3,SF,25,2,263,23,54,0.426,15,39,0.385,8,15,0.533,0.565,4,5,0.8,0,40,40,6,9,2,6,17,65
794,Reggie Bullock,4,SF,11,0,75,1,16,0.063,0,7,0,1,9,0.111,0.063,2,4,0.5,1,9,10,2,1,2,2,2,4
795,Andre Roberson,1,SG,40,16,399,33,68,0.485,2,13,0.154,31,55,0.564,0.5,7,10,0.7,36,58,94,15,19,10,19,74,75
795,Andre Roberson,2,SG,67,65,1286,92,201,0.458,21,85,0.247,71,116,0.612,0.51,23,48,0.479,60,195,255,70,53,29,46,141,228
795,Andre Roberson,3,SG,70,70,1553,136,274,0.496,32,103,0.311,104,171,0.608,0.555,33,54,0.611,79,172,251,47,53,42,35,133,337
795,Andre Roberson,4,SF,79,79,2376,215,463,0.464,45,184,0.245,170,279,0.609,0.513,47,111,0.423,98,305,403,79,94,79,51,204,522
796,Rudy Gobert,1,C,45,0,434,36,74,0.486,0,0,,36,74,0.486,0.486,32,65,0.492,51,104,155,7,8,41,32,57,104
796,Rudy Gobert,2,C,82,37,2158,258,427,0.604,0,2,0,258,425,0.607,0.604,170,273,0.623,265,510,775,109,64,189,111,175,686
796,Rudy Gobert,3,C,61,60,1932,198,354,0.559,0,0,,198,354,0.559,0.559,161,283,0.569,208,460,668,91,45,135,114,163,557
796,Rudy Gobert,4,C,81,81,2744,413,625,0.661,0,1,0,413,624,0.662,0.661,311,476,0.653,314,721,1035,97,49,214,147,246,1137
797,Livio Jean-Charles,No NBA Data,,,,,,,,,,,,,,,,,,,,,,,,,,
798,Archie Goodwin,1,SG,52,0,533,76,167,0.455,5,36,0.139,71,131,0.542,0.47,37,55,0.673,25,62,87,20,20,11,44,45,194
798,Archie Goodwin,2,SG,41,2,535,79,201,0.393,12,41,0.293,67,160,0.419,0.423,61,83,0.735,27,47,74,44,18,9,48,55,231
798,Archie Goodwin,3,PG,57,13,1114,176,422,0.417,23,99,0.232,153,323,0.474,0.444,130,193,0.674,27,115,142,118,27,13,100,84,505
798,Archie Goodwin,4,SG,15,0,214,36,66,0.545,5,15,0.333,31,51,0.608,0.583,33,42,0.786,7,21,28,24,4,5,14,8,110
799,Nemanja Nedovic,1,SG,24,0,142,8,39,0.205,3,18,0.167,5,21,0.238,0.244,7,8,0.875,3,12,15,13,0,1,13,13,26
800,Allen Crabbe,1,SG,15,0,100,12,33,0.364,6,14,0.429,6,19,0.316,0.455,3,4,0.75,1,8,9,6,2,1,3,10,33
800,Allen Crabbe,2,SG,51,9,683,63,153,0.412,30,85,0.353,33,68,0.485,0.51,12,16,0.75,7,66,73,39,19,15,15,74,168
800,Allen Crabbe,3,SG,81,8,2105,311,678,0.459,112,285,0.393,199,393,0.506,0.541,98,113,0.867,27,189,216,99,63,16,64,192,832
800,Allen Crabbe,4,SG,79,7,2254,303,647,0.468,134,302,0.444,169,345,0.49,0.572,105,124,0.847,19,207,226,94,54,20,62,171,845
801,Alex Abrines,1,SG,68,6,1055,134,341,0.393,94,247,0.381,40,94,0.426,0.531,44,49,0.898,18,68,86,40,37,8,33,114,406
801,Alex Abrines,2,SG,75,8,1134,115,291,0.395,84,221,0.38,31,70,0.443,0.54,39,46,0.848,26,88,114,28,38,8,25,124,353
801,Alex Abrines,3,SG,31,2,588,56,157,0.357,41,127,0.323,15,30,0.5,0.487,12,13,0.923,5,43,48,20,17,6,14,53,165
802,Carrick Felix,1,SG,7,0,38,7,14,0.5,2,5,0.4,5,9,0.556,0.571,3,4,0.75,1,5,6,4,0,0,4,4,19
803,Isaiah Canaan,1,PG,22,0,252,31,87,0.356,18,55,0.327,13,32,0.406,0.46,21,29,0.724,7,17,24,22,8,4,21,25,101
803,Isaiah Canaan,2,PG,47,21,938,146,378,0.386,91,246,0.37,55,132,0.417,0.507,49,60,0.817,18,69,87,98,29,3,62,83,432
803,Isaiah Canaan,3,PG,25,9,369,53,131,0.405,32,84,0.381,21,47,0.447,0.527,16,21,0.762,11,22,33,29,14,0,23,28,154
803,Isaiah Canaan,4,PG,22,12,569,93,247,0.377,59,162,0.364,34,85,0.4,0.496,33,39,0.846,7,47,54,69,15,3,39,55,278
804,Glen Rice,1,SG,11,1,109,11,37,0.297,5,17,0.294,6,20,0.3,0.365,5,7,0.714,4,16,20,7,6,1,9,7,32
804,Glen Rice,2,SG,5,0,43,3,15,0.2,1,7,0.143,2,8,0.25,0.233,4,6,0.667,2,2,4,2,0,0,2,11,11
805,Ray McCallum,1,PG,45,10,897,113,300,0.377,22,59,0.373,91,241,0.378,0.413,32,43,0.744,18,61,79,120,22,9,39,69,280
805,Ray McCallum,2,PG,68,30,1436,206,470,0.438,34,111,0.306,172,359,0.479,0.474,57,84,0.679,52,128,180,188,45,11,85,92,503
805,Ray McCallum,3,PG,41,6,475,55,146,0.377,15,42,0.357,40,104,0.385,0.428,12,15,0.8,8,39,47,60,12,7,24,29,137
805,Ray McCallum,4,PG,31,3,256,27,67,0.403,5,16,0.313,22,51,0.431,0.44,9,10,0.9,6,25,31,33,5,4,11,14,68
806,Tony Mitchell,1,PF,21,0,79,5,12,0.417,1,1,1,4,11,0.364,0.458,11,19,0.579,15,11,26,2,6,3,4,9,22
807,Nate Wolters,1,PG,58,31,1309,170,389,0.437,18,62,0.29,152,327,0.465,0.46,59,90,0.656,33,116,149,187,35,15,57,67,417
807,Nate Wolters,2,PG,21,0,247,20,57,0.351,0,7,0,20,50,0.4,0.351,2,6,0.333,8,26,34,21,8,2,13,18,42
807,Nate Wolters,3,PG,11,0,142,12,31,0.387,0,5,0,12,26,0.462,0.387,1,4,0.25,2,14,16,10,5,0,3,11,25
807,Nate Wolters,4,PG,10,0,105,8,26,0.308,0,2,0,8,24,0.333,0.308,1,2,0.5,6,12,18,11,3,2,10,7,17
808,Jeff Withey,1,C,58,4,684,69,129,0.535,0,1,0,69,128,0.539,0.535,52,73,0.712,49,101,150,26,15,50,20,73,190
808,Jeff Withey,2,C,37,0,259,32,64,0.5,0,0,,32,64,0.5,0.5,34,50,0.68,23,41,64,11,4,18,12,26,98
808,Jeff Withey,3,C,51,10,658,87,162,0.537,0,2,0,87,160,0.544,0.537,43,59,0.729,56,117,173,20,21,53,28,75,217
808,Jeff Withey,4,C,51,1,432,55,103,0.534,0,1,0,55,102,0.539,0.534,36,48,0.75,52,69,121,7,16,32,14,52,146
809,Grant Jerrett,1,PF,8,0,51,7,26,0.269,1,15,0.067,6,11,0.545,0.288,1,1,1,2,7,9,3,2,2,3,11,16
809,Grant Jerrett,2,PF,5,0,25,3,17,0.176,1,13,0.077,2,4,0.5,0.206,0,0,,1,3,4,1,0,2,2,7,7
809,Grant Jerrett,3,PF,3,0,26,4,9,0.444,0,2,0,4,7,0.571,0.444,1,1,1,1,4,5,2,2,0,1,4,9
810,Jamaal Franklin,1,SG,21,0,161,16,39,0.41,5,11,0.455,11,28,0.393,0.474,2,2,1,4,19,23,6,4,2,11,23,39
810,Jamaal Franklin,2,SG,3,0,13,1,2,0.5,1,2,0.5,0,0,,0.75,0,0,,1,1,2,3,0,1,3,4,3
811,Pierre Jackson,1,PG,8,1,84,13,39,0.333,3,11,0.273,10,28,0.357,0.372,6,7,0.857,1,8,9,19,2,0,3,5,35
812,Ricky Ledo,1,SG,11,0,33,6,17,0.353,3,8,0.375,3,9,0.333,0.441,4,4,1,0,2,2,2,1,0,2,2,19
812,Ricky Ledo,2,SG,17,0,244,32,96,0.333,10,27,0.37,22,69,0.319,0.385,16,22,0.727,16,20,36,19,6,1,26,21,90
812,Ricky Ledo,3,SG,5,0,11,0,6,0,0,3,0,0,3,0,0,1,2,0.5,1,1,2,1,0,0,2,1,1
812,Ricky Ledo,4,SG,12,0,233,32,90,0.356,10,24,0.417,22,66,0.333,0.411,15,20,0.75,15,19,34,18,6,1,24,20,89
813,Mike Muscala,1,PF,20,0,215,31,73,0.425,0,3,0,31,70,0.443,0.425,14,14,1,17,35,52,7,3,10,12,29,76
813,Mike Muscala,2,PF,40,8,502,83,151,0.55,9,22,0.409,74,129,0.574,0.579,22,25,0.88,52,67,119,25,16,19,21,52,197
813,Mike Muscala,3,C,60,0,565,76,152,0.5,12,39,0.308,64,113,0.566,0.539,31,39,0.795,38,79,117,34,13,27,27,72,195
813,Mike Muscala,4,C,70,3,1237,170,337,0.504,46,110,0.418,124,227,0.546,0.573,49,64,0.766,76,164,240,95,30,41,55,97,435
814,Marko Todorovic,No NBA Data,,,,,,,,,,,,,,,,,,,,,,,,,,
815,Erick Green,1,PG,43,1,410,61,162,0.377,14,47,0.298,47,115,0.409,0.42,10,12,0.833,7,24,31,39,12,0,14,26,146
815,Erick Green,2,PG,9,0,42,5,13,0.385,1,5,0.2,4,8,0.5,0.423,2,2,1,3,3,6,3,1,0,0,4,13
815,Erick Green,3,PG,3,0,7,0,1,0,0,1,0,0,0,,0,0,0,,0,1,1,1,0,0,0,0,0
815,Erick Green,4,PG,6,0,35,5,12,0.417,1,4,0.25,4,8,0.5,0.458,2,2,1,3,2,5,2,1,0,0,4,13
816,Raul Neto,1,PG,81,53,1499,180,418,0.431,64,162,0.395,116,256,0.453,0.507,52,70,0.743,17,103,120,174,62,2,109,122,476
816,Raul Neto,2,PG,40,0,346,41,91,0.451,10,31,0.323,31,60,0.517,0.505,8,9,0.889,4,26,30,34,21,5,15,48,100
816,Raul Neto,3,PG,41,0,498,69,151,0.457,19,47,0.404,50,104,0.481,0.52,26,35,0.743,7,42,49,75,13,4,36,38,183
816,Raul Neto,4,PG,33,1,419,67,143,0.469,19,56,0.339,48,87,0.552,0.535,25,29,0.862,5,52,57,82,14,2,28,44,178
817,Ryan Kelly,1,PF,59,25,1312,157,371,0.423,48,142,0.338,109,229,0.476,0.488,110,135,0.815,42,177,219,95,32,45,47,147,472
817,Ryan Kelly,2,PF,52,34,1233,104,309,0.337,45,134,0.336,59,175,0.337,0.409,79,95,0.832,13,133,146,92,30,24,37,118,332
817,Ryan Kelly,3,PF,36,0,470,55,149,0.369,5,37,0.135,50,112,0.446,0.386,37,54,0.685,21,100,121,20,13,10,18,39,152
817,Ryan Kelly,4,PF,16,0,110,8,28,0.286,4,10,0.4,4,18,0.222,0.357,5,6,0.833,1,17,18,8,4,5,4,5,25
818,Erik Murphy,1,C,24,0,62,3,13,0.231,0,3,0,3,10,0.3,0.231,0,0,,2,6,8,2,0,4,2,7,6
819,James Ennis,1,SF,62,3,1051,101,247,0.409,31,95,0.326,70,152,0.461,0.472,79,94,0.84,51,125,176,48,25,17,39,89,312
819,James Ennis,2,SF,22,5,329,54,113,0.478,26,58,0.448,28,55,0.509,0.593,25,34,0.735,21,21,42,21,16,5,19,28,159
819,James Ennis,3,SF,3,0,7,0,0,,0,0,,0,0,,,0,0,,0,0,0,1,0,0,0,1,0
819,James Ennis,4,SF,10,0,40,4,13,0.308,2,8,0.25,2,5,0.4,0.385,6,10,0.6,4,3,7,2,4,2,2,1,16
820,Romero Osby,No NBA Data,,,,,,,,,,,,,,,,,,,,,,,,,,
821,Lorenzo Brown,1,PG,26,0,224,26,86,0.302,3,30,0.1,23,56,0.411,0.32,9,13,0.692,8,20,28,41,13,3,16,19,64
821,Lorenzo Brown,2,PG,29,7,549,52,122,0.426,6,28,0.214,46,94,0.489,0.451,12,19,0.632,14,56,70,90,28,6,30,49,122
821,Lorenzo Brown,3,PG,8,0,61,8,25,0.32,1,8,0.125,7,17,0.412,0.34,3,4,0.75,0,7,7,11,3,1,9,4,20
821,Lorenzo Brown,4,PG,14,0,139,14,34,0.412,2,12,0.167,12,22,0.545,0.441,2,2,1,1,14,15,13,5,0,3,7,32
822,Colton Iverson,No NBA Data,,,,,,,,,,,,,,,,,,,,,,,,,,
823,Arsalan Kazemi,No NBA Data,,,,,,,,,,,,,,,,,,,,,,,,,,
824,Joffrey Lauvergne,1,C,24,1,268,36,89,0.404,3,16,0.188,33,73,0.452,0.421,18,28,0.643,27,50,77,13,8,10,22,43,93
824,Joffrey Lauvergne,2,C,59,15,1041,195,380,0.513,13,53,0.245,182,327,0.557,0.53,62,69,0.899,77,213,290,56,13,15,54,115,465
824,Joffrey Lauvergne,3,PF-C,70,1,980,148,336,0.44,33,98,0.337,115,238,0.483,0.49,46,73,0.63,72,179,251,70,25,6,56,83,375
824,Joffrey Lauvergne,4,PF,50,0,739,111,244,0.455,27,78,0.346,84,166,0.506,0.51,37,58,0.638,51,132,183,51,18,6,40,71,286
825,Peyton Siva,1,SG,24,0,224,18,57,0.316,7,25,0.28,11,32,0.344,0.377,11,15,0.733,2,12,14,34,9,1,18,27,54
826,Alex Oriakhi,No NBA Data,,,,,,,,,,,,,,,,,,,,,,,,,,
827,Deshaun Thomas,No NBA Data,,,,,,,,,,,,,,,,,,,,,,,,,,
828,Bojan Dubljevic,No NBA Data,,,,,,,,,,,,,,,,,,,,,,,,,,
829,Janis Timma,No NBA Data,,,,,,,,,,,,,,,,,,,,,,,,,,
830,Andrew Wiggins,1,SF,82,82,2969,497,1137,0.437,39,126,0.31,458,1011,0.453,0.454,354,466,0.76,134,240,374,170,86,50,177,190,1387
830,Andrew Wiggins,2,SF,81,81,2845,594,1294,0.459,57,190,0.3,537,1104,0.486,0.481,430,565,0.761,105,186,291,164,78,46,182,165,1675
830,Andrew Wiggins,3,SF,82,82,3048,709,1570,0.452,103,289,0.356,606,1281,0.473,0.484,412,542,0.76,102,226,328,189,82,30,187,183,1933
830,Andrew Wiggins,4,SF,82,82,2979,569,1300,0.438,112,338,0.331,457,962,0.475,0.481,202,314,0.643,82,276,358,160,91,51,138,163,1452
831,Jabari Parker,1,PF,25,25,738,129,263,0.49,4,16,0.25,125,247,0.506,0.498,46,66,0.697,50,88,138,42,31,5,47,42,308
831,Jabari Parker,2,PF,76,72,2408,443,899,0.493,9,35,0.257,434,864,0.502,0.498,175,228,0.768,123,272,395,130,69,29,116,154,1070
831,Jabari Parker,3,PF,51,50,1728,399,814,0.49,65,178,0.365,334,636,0.525,0.53,162,218,0.743,79,235,314,142,50,22,93,111,1025
831,Jabari Parker,4,PF,31,3,743,160,332,0.482,31,81,0.383,129,251,0.514,0.529,40,54,0.741,42,109,151,59,25,10,45,50,391
832,Joel Embiid,1,C,31,31,786,200,429,0.466,36,98,0.367,164,331,0.495,0.508,191,244,0.783,61,182,243,66,27,76,117,112,627
832,Joel Embiid,2,C,63,63,1912,510,1056,0.483,66,214,0.308,444,842,0.527,0.514,359,467,0.769,143,547,690,199,40,111,234,209,1445
832,Joel Embiid,3,C,61,61,2062,547,1132,0.483,73,247,0.296,474,885,0.536,0.515,501,617,0.812,153,682,835,210,41,115,219,203,1668
833,Aaron Gordon,1,PF,47,8,797,93,208,0.447,13,48,0.271,80,160,0.5,0.478,44,61,0.721,46,123,169,33,21,22,38,83,243
833,Aaron Gordon,2,PF,78,37,1863,274,579,0.473,42,142,0.296,232,437,0.531,0.509,129,193,0.668,154,353,507,128,59,55,66,153,719
833,Aaron Gordon,3,SF,80,72,2298,393,865,0.454,77,267,0.288,316,598,0.528,0.499,156,217,0.719,116,289,405,150,65,40,89,172,1019
833,Aaron Gordon,4,PF,58,57,1909,375,865,0.434,115,342,0.336,260,523,0.497,0.5,157,225,0.698,87,370,457,136,59,45,107,111,1022
834,Dante Exum,1,PG,82,41,1817,145,416,0.349,83,264,0.314,62,152,0.408,0.448,20,32,0.625,27,104,131,198,41,14,118,147,393
834,Dante Exum,2,PG,66,26,1228,155,363,0.427,44,149,0.295,111,214,0.519,0.488,58,73,0.795,30,102,132,111,21,12,80,146,412
834,Dante Exum,3,PG,14,0,235,42,87,0.483,5,18,0.278,37,69,0.536,0.511,25,31,0.806,4,22,26,43,8,3,20,20,114
834,Dante Exum,4,PG,42,1,664,101,241,0.419,18,62,0.29,83,179,0.464,0.456,68,86,0.791,16,52,68,110,14,5,52,69,288
835,Marcus Smart,1,PG,67,38,1808,175,477,0.367,91,272,0.335,84,205,0.41,0.462,82,127,0.646,61,161,222,208,99,18,90,176,523
835,Marcus Smart,2,PG,61,10,1667,184,529,0.348,61,241,0.253,123,288,0.427,0.405,129,166,0.777,76,179,255,185,91,18,80,183,558
835,Marcus Smart,3,SG,79,24,2399,269,749,0.359,94,332,0.283,175,417,0.42,0.422,203,250,0.812,78,227,305,364,125,34,159,192,835
835,Marcus Smart,4,SG,54,11,1614,189,515,0.367,75,249,0.301,114,266,0.429,0.44,97,133,0.729,43,146,189,259,71,23,129,133,550
836,Julius Randle,1,PF,1,0,14,1,3,0.333,0,0,,1,3,0.333,0.333,0,2,0,0,0,0,0,0,0,1,1,2
836,Julius Randle,2,PF,81,60,2286,358,835,0.429,10,36,0.278,348,799,0.436,0.435,193,270,0.715,172,657,829,144,53,29,149,242,919
836,Julius Randle,3,PF,74,73,2132,377,773,0.488,17,63,0.27,360,710,0.507,0.499,204,282,0.723,150,486,636,264,49,37,173,248,975
836,Julius Randle,4,C,82,49,2190,504,904,0.558,10,45,0.222,494,859,0.575,0.563,305,425,0.718,181,473,654,210,43,45,213,274,1323
837,Nik Stauskas,1,SG,73,1,1127,108,296,0.365,48,149,0.322,60,147,0.408,0.446,55,64,0.859,11,77,88,67,20,17,40,92,319
837,Nik Stauskas,2,SG,73,35,1809,210,545,0.385,106,325,0.326,104,220,0.473,0.483,91,118,0.771,23,160,183,138,44,20,94,115,617
837,Nik Stauskas,3,SG,80,27,2188,251,634,0.396,132,359,0.368,119,275,0.433,0.5,122,150,0.813,21,205,226,188,45,32,128,144,756
837,Nik Stauskas,4,SG,41,0,523,60,154,0.39,40,100,0.4,20,54,0.37,0.519,21,29,0.724,4,60,64,39,9,4,26,24,181
838,Noah Vonleh,1,PF,25,0,259,30,76,0.395,5,13,0.385,25,63,0.397,0.428,18,26,0.692,28,58,86,4,4,9,11,20,83
838,Noah Vonleh,2,PF,78,56,1174,117,278,0.421,11,46,0.239,106,232,0.457,0.441,38,51,0.745,91,214,305,30,27,26,50,152,283
838,Noah Vonleh,3,PF,74,41,1265,130,270,0.481,7,20,0.35,123,250,0.492,0.494,60,94,0.638,131,256,387,31,30,27,64,154,327
838,Noah Vonleh,4,PF,54,16,875,104,234,0.444,20,66,0.303,84,168,0.5,0.487,36,58,0.621,70,241,311,34,19,17,31,68,264
839,Elfrid Payton,1,PG,82,63,2489,301,708,0.425,11,42,0.262,290,666,0.435,0.433,118,214,0.551,107,242,349,533,142,20,203,193,731
839,Elfrid Payton,2,PG,73,69,2145,318,730,0.436,30,92,0.326,288,638,0.451,0.456,112,190,0.589,77,184,261,468,89,20,177,159,778
839,Elfrid Payton,3,PG,82,58,2412,430,912,0.471,40,146,0.274,390,766,0.509,0.493,146,211,0.692,89,298,387,529,88,40,178,177,1046
839,Elfrid Payton,4,PG,63,63,1808,329,667,0.493,30,92,0.326,299,575,0.52,0.516,109,168,0.649,64,210,274,393,83,22,168,147,797
840,Doug McDermott,1,SF,36,0,321,43,107,0.402,13,41,0.317,30,66,0.455,0.463,10,15,0.667,6,37,43,6,4,1,17,29,109
840,Doug McDermott,2,SF,81,4,1861,291,644,0.452,110,259,0.425,181,385,0.47,0.537,72,84,0.857,37,158,195,59,14,6,53,127,764
840,Doug McDermott,3,SF,66,5,1508,222,497,0.447,77,208,0.37,145,289,0.502,0.524,71,84,0.845,20,159,179,58,13,5,38,79,592
840,Doug McDermott,4,SF,44,4,1078,166,373,0.445,56,150,0.373,110,223,0.493,0.52,59,67,0.881,14,116,130,45,11,4,32,57,447
841,Dario Saric,1,PF,81,36,2129,381,927,0.411,106,341,0.311,275,586,0.469,0.468,172,220,0.782,112,401,513,182,57,30,183,162,1040
841,Dario Saric,2,PF,78,73,2310,403,890,0.453,157,399,0.393,246,491,0.501,0.541,178,207,0.86,154,366,520,202,51,20,148,160,1141
841,Dario Saric,3,PF,73,33,1801,265,609,0.435,104,282,0.369,161,327,0.492,0.521,115,133,0.865,117,296,413,112,42,8,92,163,749
841,Dario Saric,4,PF,13,13,396,48,132,0.364,21,70,0.3,27,62,0.435,0.443,27,30,0.9,21,65,86,26,4,3,25,39,144
842,Zach LaVine,1,PG,77,40,1902,286,677,0.422,57,167,0.341,229,510,0.449,0.465,149,177,0.842,27,187,214,276,54,10,193,158,778
842,Zach LaVine,2,SG,82,33,2294,433,959,0.452,123,316,0.389,310,643,0.482,0.516,161,203,0.793,27,201,228,251,69,17,155,193,1150
842,Zach LaVine,3,SG,47,47,1749,326,710,0.459,120,310,0.387,206,400,0.515,0.544,117,140,0.836,19,141,160,139,41,10,85,104,889
842,Zach LaVine,4,SG,24,24,656,136,355,0.383,42,123,0.341,94,232,0.405,0.442,87,107,0.813,9,85,94,72,24,4,43,55,401
843,T.J. Warren,1,SF,40,1,614,113,214,0.528,5,21,0.238,108,193,0.56,0.54,14,19,0.737,41,44,85,25,18,9,27,51,245
843,T.J. Warren,2,SF,47,4,1070,221,441,0.501,28,70,0.4,193,371,0.52,0.533,45,64,0.703,57,90,147,44,37,16,32,94,515
843,T.J. Warren,3,SF,66,59,2048,403,814,0.495,26,98,0.265,377,716,0.527,0.511,119,154,0.773,125,214,339,75,76,39,57,175,951
843,T.J. Warren,4,SF,65,65,2142,529,1063,0.498,20,90,0.222,509,973,0.523,0.507,193,255,0.757,125,208,333,85,65,41,85,149,1271
844,Adreian Payne,1,PF,32,22,739,91,220,0.414,1,9,0.111,90,211,0.427,0.416,30,46,0.652,48,114,162,30,19,9,44,88,213
844,Adreian Payne,2,PF,3,0,19,2,7,0.286,0,1,0,2,6,0.333,0.286,1,2,0.5,1,3,4,0,1,0,0,4,5
844,Adreian Payne,3,PF,29,22,720,89,213,0.418,1,8,0.125,88,205,0.429,0.42,29,44,0.659,47,111,158,30,18,9,44,84,208
844,Adreian Payne,4,PF,52,2,486,53,145,0.366,9,32,0.281,44,113,0.389,0.397,17,26,0.654,20,91,111,29,16,11,36,77,132
845,Jusuf Nurkic,1,C,62,27,1103,171,383,0.446,0,2,0,171,381,0.449,0.446,84,132,0.636,125,257,382,50,52,68,86,207,426
845,Jusuf Nurkic,2,C,32,3,547,101,242,0.417,0,3,0,101,239,0.423,0.417,61,99,0.616,65,110,175,40,24,44,55,91,263
845,Jusuf Nurkic,3,C,65,48,1391,271,534,0.507,0,1,0,271,533,0.508,0.507,120,210,0.571,154,313,467,123,50,74,143,161,662
845,Jusuf Nurkic,4,C,45,29,807,151,298,0.507,0,0,,151,298,0.507,0.507,56,113,0.496,89,171,260,60,25,36,81,88,358
846,James Young,1,SG,31,0,332,36,102,0.353,17,66,0.258,19,36,0.528,0.436,16,29,0.552,9,33,42,13,8,2,5,22,105
846,James Young,2,SG,29,0,199,11,36,0.306,6,26,0.231,5,10,0.5,0.389,1,4,0.25,4,22,26,9,6,1,5,17,29
846,James Young,3,SG,29,0,220,25,58,0.431,12,35,0.343,13,23,0.565,0.534,6,9,0.667,6,20,26,4,10,2,4,15,68
846,James Young,4,SG,6,0,61,5,14,0.357,3,10,0.3,2,4,0.5,0.464,4,6,0.667,0,2,2,2,0,0,1,4,17
847,Tyler Ennis,1,PG,33,1,411,52,144,0.361,12,43,0.279,40,101,0.396,0.403,5,7,0.714,7,28,35,73,18,5,42,36,121
847,Tyler Ennis,2,PG,8,0,58,9,21,0.429,2,6,0.333,7,15,0.467,0.476,2,2,1,1,6,7,14,0,2,8,3,22
847,Tyler Ennis,3,PG,25,1,353,43,123,0.35,10,37,0.27,33,86,0.384,0.39,3,5,0.6,6,22,28,59,18,3,34,33,99
847,Tyler Ennis,4,PG,46,7,654,84,187,0.449,13,39,0.333,71,148,0.48,0.484,25,34,0.735,13,62,75,95,25,1,46,64,206
848,Gary Harris,1,SG,55,6,719,66,217,0.304,21,103,0.204,45,114,0.395,0.353,35,47,0.745,21,43,64,29,39,7,38,71,188
848,Gary Harris,2,SG,76,76,2439,359,765,0.469,105,297,0.354,254,468,0.543,0.538,109,133,0.82,54,166,220,147,97,18,98,143,932
848,Gary Harris,3,SG,57,56,1782,320,637,0.502,107,255,0.42,213,382,0.558,0.586,104,134,0.776,48,130,178,164,71,8,76,92,851
848,Gary Harris,4,SG,67,65,2304,440,908,0.485,156,394,0.396,284,514,0.553,0.57,134,162,0.827,37,139,176,194,122,15,119,119,1170
849,Bruno Caboclo,1,SF,8,0,23,4,12,0.333,2,3,0.667,2,9,0.222,0.417,0,0,,1,1,2,0,0,1,4,3,10
849,Bruno Caboclo,2,SF,6,1,43,1,12,0.083,1,7,0.143,0,5,0,0.125,0,0,,1,1,2,1,2,1,4,2,3
849,Bruno Caboclo,3,SF,9,0,40,6,16,0.375,2,6,0.333,4,10,0.4,0.438,0,0,,5,5,10,4,2,1,2,4,14
849,Bruno Caboclo,4,SF,12,0,107,9,31,0.29,3,17,0.176,6,14,0.429,0.339,5,6,0.833,7,15,22,4,3,4,4,8,26
850,Mitch McGary,1,PF,32,2,485,88,165,0.533,0,2,0,88,163,0.54,0.533,25,40,0.625,53,112,165,14,16,16,31,72,201
850,Mitch McGary,2,PF,20,0,72,11,23,0.478,0,4,0,11,19,0.579,0.478,4,10,0.4,4,14,18,3,1,2,7,10,26
851,Jordan Adams,1,SG,30,0,248,35,86,0.407,10,25,0.4,25,61,0.41,0.465,14,23,0.609,9,19,28,16,16,7,14,24,94
851,Jordan Adams,2,SG,2,0,15,2,6,0.333,0,1,0,2,5,0.4,0.333,3,5,0.6,0,2,2,3,3,0,2,2,7
852,Rodney Hood,1,SG,50,21,1064,155,374,0.414,62,170,0.365,93,204,0.456,0.497,61,80,0.763,9,108,117,83,30,12,45,119,433
852,Rodney Hood,2,SG,79,79,2541,408,972,0.42,161,449,0.359,247,523,0.472,0.503,172,200,0.86,38,229,267,213,73,16,125,202,1149
852,Rodney Hood,3,SG,59,55,1593,272,666,0.408,114,307,0.371,158,359,0.44,0.494,90,115,0.783,16,186,202,96,38,11,65,132,748
852,Rodney Hood,4,SG,60,23,1616,322,751,0.429,127,333,0.381,195,418,0.467,0.513,111,129,0.86,22,143,165,95,45,12,70,105,882
853,Shabazz Napier,1,PG,51,10,1012,87,228,0.382,43,118,0.364,44,110,0.4,0.476,44,56,0.786,17,96,113,130,40,4,81,76,261
853,Shabazz Napier,2,PG,55,0,600,68,201,0.338,34,104,0.327,34,97,0.351,0.423,33,45,0.733,9,46,55,97,23,1,46,38,203
853,Shabazz Napier,3,PG,53,2,512,73,183,0.399,34,92,0.37,39,91,0.429,0.492,38,49,0.776,8,53,61,67,32,2,41,38,218
853,Shabazz Napier,4,PG,74,10,1535,223,531,0.42,82,218,0.376,141,313,0.45,0.497,116,138,0.841,26,144,170,150,81,14,90,84,644
854,Clint Capela,1,C,12,0,90,14,29,0.483,0,0,,14,29,0.483,0.483,4,23,0.174,10,26,36,2,1,9,5,14,32
854,Clint Capela,2,C,77,35,1471,231,397,0.582,0,1,0,231,396,0.583,0.582,80,211,0.379,194,300,494,47,59,92,60,190,542
854,Clint Capela,3,C,65,59,1551,362,563,0.643,0,0,,362,563,0.643,0.643,94,177,0.531,178,348,526,63,34,79,87,179,818
854,Clint Capela,4,C,74,74,2034,441,676,0.652,0,1,0,441,675,0.653,0.652,144,257,0.56,241,561,802,68,58,137,103,185,1026
855,P.J. Hairston,1,SG,45,2,687,87,269,0.323,49,163,0.301,38,106,0.358,0.414,31,36,0.861,22,70,92,21,21,13,22,61,254
855,P.J. Hairston,2,SF,66,52,1313,145,408,0.355,70,241,0.29,75,167,0.449,0.441,50,64,0.781,25,149,174,38,32,11,41,137,410
855,P.J. Hairston,3,SF,48,43,938,99,276,0.359,54,172,0.314,45,104,0.433,0.457,34,42,0.81,18,110,128,29,24,7,24,106,286
855,P.J. Hairston,4,SF,18,9,375,46,132,0.348,16,69,0.232,30,63,0.476,0.409,16,22,0.727,7,39,46,9,8,4,17,31,124
856,Bogdan Bogdanovic,1,SG,78,53,2175,344,772,0.446,129,329,0.392,215,443,0.485,0.529,100,119,0.84,31,192,223,258,72,16,125,172,917
856,Bogdan Bogdanovic,2,SG,62,17,1727,317,769,0.412,114,328,0.348,203,441,0.46,0.486,120,146,0.822,32,185,217,238,66,14,108,135,868
857,C.J. Wilcox,1,SG,21,0,101,16,38,0.421,7,19,0.368,9,19,0.474,0.513,2,2,1,1,6,7,8,3,1,10,7,41
857,C.J. Wilcox,2,SG,23,0,167,26,66,0.394,9,23,0.391,17,43,0.395,0.462,9,12,0.75,1,11,12,10,10,2,2,15,70
857,C.J. Wilcox,3,SG,22,0,108,8,31,0.258,3,15,0.2,5,16,0.313,0.306,2,2,1,4,8,12,12,2,1,6,8,21
858,Josh Huestis,1,PF,5,0,55,5,12,0.417,4,6,0.667,1,6,0.167,0.583,0,4,0,2,8,10,0,1,2,3,3,14
858,Josh Huestis,2,PF,2,0,31,6,11,0.545,2,4,0.5,4,7,0.571,0.636,0,1,0,4,5,9,3,0,3,0,0,14
858,Josh Huestis,3,PF,69,10,982,60,182,0.33,33,115,0.287,27,67,0.403,0.42,6,20,0.3,42,119,161,20,15,43,26,82,159
859,Kyle Anderson,1,SF,33,8,358,31,89,0.348,3,11,0.273,28,78,0.359,0.365,9,14,0.643,5,67,72,28,15,7,10,28,74
859,Kyle Anderson,2,SF,78,11,1245,138,295,0.468,12,37,0.324,126,258,0.488,0.488,62,83,0.747,25,219,244,123,60,29,59,97,350
859,Kyle Anderson,3,SF,72,14,1020,93,209,0.445,15,40,0.375,78,169,0.462,0.481,45,57,0.789,33,175,208,91,51,26,39,63,246
859,Kyle Anderson,4,SF,74,67,1978,231,438,0.527,19,57,0.333,212,381,0.556,0.549,104,146,0.712,84,312,396,202,115,60,94,114,585
860,Damien Inglis,1,SF,20,1,156,13,37,0.351,3,13,0.231,10,24,0.417,0.392,7,8,0.875,2,29,31,10,6,3,11,11,36
861,K.J. McDaniels,1,SG,62,15,1352,172,434,0.396,43,150,0.287,129,284,0.454,0.446,100,133,0.752,65,135,200,72,44,70,105,126,487
861,K.J. McDaniels,2,SG,52,15,1319,167,419,0.399,43,147,0.293,124,272,0.456,0.45,99,131,0.756,64,131,195,70,44,68,104,121,476
861,K.J. McDaniels,3,SG,10,0,33,5,15,0.333,0,3,0,5,12,0.417,0.333,1,2,0.5,1,4,5,2,0,2,1,5,11
861,K.J. McDaniels,4,SF,37,1,235,29,72,0.403,7,25,0.28,22,47,0.468,0.451,24,30,0.8,16,26,42,10,7,6,17,30,89
862,Joe Harris,1,SG,51,1,493,48,120,0.4,31,84,0.369,17,36,0.472,0.529,9,15,0.6,7,34,41,26,7,2,27,62,136
862,Joe Harris,2,SG,5,0,15,1,4,0.25,1,4,0.25,0,0,,0.375,0,0,,0,3,3,2,0,0,1,1,3
862,Joe Harris,3,SG,52,11,1138,154,362,0.425,85,221,0.385,69,141,0.489,0.543,35,49,0.714,16,131,147,54,30,8,55,121,428
862,Joe Harris,4,SG,78,14,1975,305,621,0.491,150,358,0.419,155,263,0.589,0.612,86,104,0.827,51,209,260,128,35,20,91,153,846
863,Cleanthony Early,1,SF,39,7,647,76,214,0.355,22,84,0.262,54,130,0.415,0.407,36,48,0.75,22,75,97,36,24,12,40,57,210
863,Cleanthony Early,2,SF,17,2,154,12,40,0.3,4,15,0.267,8,25,0.32,0.35,3,4,0.75,4,22,26,6,2,3,9,16,31
864,Jarnell Stokes,1,PF,19,2,126,21,37,0.568,0,0,,21,37,0.568,0.568,15,28,0.536,16,18,34,4,5,5,7,25,57
864,Jarnell Stokes,2,C,7,0,18,3,5,0.6,0,0,,3,5,0.6,0.6,1,2,0.5,1,3,4,1,1,0,0,1,7
864,Jarnell Stokes,3,C,2,0,4,0,0,,0,0,,0,0,,,0,0,,1,1,2,0,0,0,0,0,0
864,Jarnell Stokes,4,C,5,0,14,3,5,0.6,0,0,,3,5,0.6,0.6,1,2,0.5,0,2,2,1,1,0,0,1,7
865,Johnny O'Bryant III,1,PF,34,15,368,44,120,0.367,0,0,,44,120,0.367,0.367,12,27,0.444,26,38,64,17,5,4,25,44,100
865,Johnny O'Bryant III,2,PF,66,4,857,86,209,0.411,1,1,1,85,208,0.409,0.414,27,40,0.675,65,111,176,32,18,8,31,100,200
865,Johnny O'Bryant III,3,PF,11,0,80,15,30,0.5,3,6,0.5,12,24,0.5,0.55,5,6,0.833,9,10,19,6,0,1,6,10,38
865,Johnny O'Bryant III,4,PF,7,0,46,7,15,0.467,2,3,0.667,5,12,0.417,0.533,4,4,1,5,6,11,2,0,1,3,4,20
866,DeAndre Daniels,No NBA Data,,,,,,,,,,,,,,,,,,,,,,,,,,
867,Spencer Dinwiddie,1,PG,34,1,455,51,169,0.302,12,65,0.185,39,104,0.375,0.337,31,34,0.912,4,44,48,104,19,6,33,53,145
867,Spencer Dinwiddie,2,PG,12,0,159,19,54,0.352,1,10,0.1,18,44,0.409,0.361,19,33,0.576,4,13,17,22,3,0,7,20,58
867,Spencer Dinwiddie,3,PG,59,18,1334,134,302,0.444,38,101,0.376,96,201,0.478,0.507,126,159,0.792,27,137,164,185,44,23,66,119,432
867,Spencer Dinwiddie,4,PG,80,58,2306,324,838,0.387,141,433,0.326,183,405,0.452,0.471,218,268,0.813,40,219,259,524,68,23,128,186,1007
868,Jerami Grant,1,SF,65,11,1377,124,352,0.352,49,156,0.314,75,196,0.383,0.422,114,193,0.591,49,149,198,79,40,68,85,144,411
868,Jerami Grant,2,PF,77,52,2066,251,599,0.419,35,146,0.24,216,453,0.477,0.448,212,322,0.658,99,262,361,135,54,127,110,215,749
868,Jerami Grant,3,PF,80,4,1531,152,328,0.463,43,116,0.371,109,212,0.514,0.529,90,147,0.612,38,167,205,46,33,79,44,149,437
868,Jerami Grant,4,PF,2,0,41,6,17,0.353,0,2,0,6,15,0.4,0.353,4,8,0.5,0,6,6,0,0,4,3,5,16
869,Glenn Robinson III,1,SG-SF,35,1,261,26,67,0.388,5,19,0.263,21,48,0.438,0.425,16,24,0.667,15,24,39,11,6,1,11,15,73
869,Glenn Robinson III,2,SG,25,0,108,8,24,0.333,1,6,0.167,7,18,0.389,0.354,12,16,0.75,4,10,14,3,3,0,3,5,29
869,Glenn Robinson III,3,SF,10,1,153,18,43,0.419,4,13,0.308,14,30,0.467,0.465,4,8,0.5,11,14,25,8,3,1,8,10,44
869,Glenn Robinson III,4,SF,45,4,508,65,151,0.43,14,37,0.378,51,114,0.447,0.477,27,39,0.692,12,56,68,26,17,9,18,21,171
870,Nikola Jokic,1,C,80,55,1733,307,600,0.512,28,84,0.333,279,516,0.541,0.535,154,190,0.811,181,379,560,189,79,50,104,208,796
870,Nikola Jokic,2,C,73,59,2038,494,854,0.578,45,139,0.324,449,715,0.628,0.605,188,228,0.825,212,506,718,359,61,55,171,214,1221
870,Nikola Jokic,3,C,75,73,2443,504,1010,0.499,111,280,0.396,393,730,0.538,0.554,266,313,0.85,195,608,803,458,90,61,210,212,1385
870,Nikola Jokic,4,C,72,72,2269,552,1094,0.505,80,250,0.32,472,844,0.559,0.541,275,331,0.831,211,568,779,539,95,50,224,202,1459
871,Nick Johnson,1,SG,28,0,262,26,75,0.347,5,21,0.238,21,54,0.389,0.38,17,25,0.68,13,26,39,11,7,3,19,34,74
872,Walter Tavares,1,C,11,0,73,11,19,0.579,0,0,,11,19,0.579,0.579,3,8,0.375,7,14,21,3,1,6,5,8,25
872,Walter Tavares,2,C,2,0,28,4,5,0.8,0,0,,4,5,0.8,0.8,0,3,0,4,7,11,1,0,6,2,3,8
872,Walter Tavares,3,C,1,0,4,1,1,1,0,0,,1,1,1,1,0,2,0,0,1,1,0,0,0,0,0,2
872,Walter Tavares,4,C,1,0,24,3,4,0.75,0,0,,3,4,0.75,0.75,0,1,0,4,6,10,1,0,6,2,3,6
873,Markel Brown,1,SG,47,29,781,76,210,0.362,17,64,0.266,59,146,0.404,0.402,47,57,0.825,16,91,107,39,31,12,27,57,216
873,Markel Brown,2,SG,62,6,982,127,322,0.394,38,121,0.314,89,201,0.443,0.453,71,94,0.755,23,99,122,91,38,15,54,94,363
873,Markel Brown,3,SG,4,0,31,2,7,0.286,1,5,0.2,1,2,0.5,0.357,0,0,,1,4,5,2,0,0,2,6,5
874,Dwight Powell,1,PF,29,0,236,31,67,0.463,3,11,0.273,28,56,0.5,0.485,25,33,0.758,18,32,50,9,9,6,11,40,90
874,Dwight Powell,2,PF,5,0,9,4,5,0.8,0,0,,4,5,0.8,0.8,1,2,0.5,0,1,1,0,2,0,2,1,9
874,Dwight Powell,3,PF,24,0,227,27,62,0.435,3,11,0.273,24,51,0.471,0.46,24,31,0.774,18,31,49,9,7,6,9,39,81
874,Dwight Powell,4,PF,69,2,992,146,296,0.493,2,16,0.125,144,280,0.514,0.497,105,142,0.739,84,189,273,44,36,24,40,118,399
875,Jordan Clarkson,1,PG,59,38,1476,267,596,0.448,38,121,0.314,229,475,0.482,0.48,131,158,0.829,56,135,191,206,51,12,96,109,703
875,Jordan Clarkson,2,SG,79,79,2552,475,1098,0.433,111,320,0.347,364,778,0.468,0.483,164,204,0.804,93,220,313,192,88,7,135,168,1225
875,Jordan Clarkson,3,SG,82,19,2397,477,1071,0.445,117,356,0.329,360,715,0.503,0.5,134,168,0.798,49,197,246,213,88,8,164,150,1205
875,Jordan Clarkson,4,SG,81,2,1888,430,954,0.451,112,318,0.352,318,636,0.5,0.509,152,190,0.8,57,160,217,221,58,6,127,107,1124
876,Russ Smith,1,PG,12,0,65,8,25,0.32,2,11,0.182,6,14,0.429,0.36,12,13,0.923,1,5,6,8,3,0,12,13,30
876,Russ Smith,2,PG,6,0,29,2,10,0.2,1,6,0.167,1,4,0.25,0.25,0,0,,0,3,3,2,0,0,7,6,5
876,Russ Smith,3,PG,6,0,36,6,15,0.4,1,5,0.2,5,10,0.5,0.433,12,13,0.923,1,2,3,6,3,0,5,7,25
876,Russ Smith,4,PG,15,0,66,7,22,0.318,1,5,0.2,6,17,0.353,0.341,8,13,0.615,1,8,9,11,5,1,7,5,23
877,Lamar Patterson,1,SG,35,0,395,28,80,0.35,12,49,0.245,16,31,0.516,0.425,16,22,0.727,4,46,50,39,9,2,23,45,84
877,Lamar Patterson,2,SG,5,0,40,3,15,0.2,1,6,0.167,2,9,0.222,0.233,2,3,0.667,1,6,7,6,1,0,4,6,9
878,Cameron Bairstow,1,PF,18,1,64,3,14,0.214,0,0,,3,14,0.214,0.214,4,5,0.8,6,2,8,1,2,1,3,8,10
878,Cameron Bairstow,2,C,18,2,103,13,40,0.325,1,5,0.2,12,35,0.343,0.338,7,8,0.875,4,24,28,6,2,3,4,19,34
879,Alec Brown,No NBA Data,,,,,,,,,,,,,,,,,,,,,,,,,,
880,Thanasis Antetokounmpo,1,SF,2,0,6,3,4,0.75,0,1,0,3,3,1,0.75,0,0,,0,1,1,0,0,0,0,2,6
881,Vasilije Micic,No NBA Data,,,,,,,,,,,,,,,,,,,,,,,,,,
882,Alessandro Gentile,No NBA Data,,,,,,,,,,,,,,,,,,,,,,,,,,
883,Nemanja Dangubic,No NBA Data,,,,,,,,,,,,,,,,,,,,,,,,,,
884,Semaj Christon,1,PG,64,1,973,77,223,0.345,12,63,0.19,65,160,0.406,0.372,17,31,0.548,19,68,87,130,28,7,43,79,183
885,Roy Devyn Marble,1,SG,16,7,208,14,44,0.318,4,22,0.182,10,22,0.455,0.364,5,16,0.313,5,26,31,17,9,2,9,14,37
885,Roy Devyn Marble,2,SG,28,0,249,21,71,0.296,8,32,0.25,13,39,0.333,0.352,10,24,0.417,6,32,38,12,13,1,7,25,60
886,Louis Labeyrie,No NBA Data,,,,,,,,,,,,,,,,,,,,,,,,,,
887,Jordan McRae,1,PG,22,1,195,34,78,0.436,10,22,0.455,24,56,0.429,0.5,21,28,0.75,4,16,20,25,3,1,15,17,99
887,Jordan McRae,2,PG,7,0,82,11,26,0.423,3,11,0.273,8,15,0.533,0.481,12,15,0.8,2,6,8,10,3,0,6,7,37
887,Jordan McRae,3,PG,15,1,113,23,52,0.442,7,11,0.636,16,41,0.39,0.51,9,13,0.692,2,10,12,15,0,1,9,10,62
887,Jordan McRae,4,SG,37,4,384,58,150,0.387,18,51,0.353,40,99,0.404,0.447,27,34,0.794,6,35,41,19,8,6,14,31,161
888,Xavier Thames,No NBA Data,,,,,,,,,,,,,,,,,,,,,,,,,,
889,Cory Jefferson,1,PF,50,1,531,75,167,0.449,2,15,0.133,73,152,0.48,0.455,31,54,0.574,47,98,145,16,10,21,20,61,183
889,Cory Jefferson,2,PF,8,0,50,9,22,0.409,0,1,0,9,21,0.429,0.409,4,6,0.667,6,10,16,0,0,1,0,8,22